chrom	TSS	TTS	ClusterType	Genes	SSDGenes	WGDGenes	Singletons	TotalGenes
chrI	334	792	Complement	YAL069W,YAL068W-A	0	0	2	2
chrI	1806	9017	SSDCluster	YAL068C,YAL067W-A,YAL067C	2	0	1	3
chrI	9591	22687	Complement	YAL066W,YAL065C,YAL064W-B,YAL064C-A,YAL064W,YAL063C-A	0	0	6	6
chrI	24000	45023	SSDCluster	YAL063C,YAL062W,YAL061W,YAL060W,YAL059C-A,YAL059W,YAL058W,YAL056C-A,YAL056W,YAL055W,YAL054C	4	2	5	11
chrI	45899	51708	WGDCluster	YAL053W,YAL051W	0	2	0	2
chrI	51855	61053	Complement	YAL049C,YAL048C,YAL047W-A,YAL047C,YAL046C,YAL045C,YAL044W-A,YAL044C,YAL043C	0	0	9	9
chrI	61231	69526	SSDCluster	YAL042C-A,YAL042W,YAL041W,YAL040C,YAL039C	3	0	2	5
chrI	71786	94487	WGDCluster	YAL038W,YAL037C-B,YAL037C-A,YAL037W,YAL036C,YAL035W,YAL034C-B,YAL034W-A,YAL034C,YAL033W,YAL032C,YAL031W-A,YAL031C,YAL030W,YAL029C,YAL028W	2	6	8	16
chrI	94687	105873	Complement	YAL027W,YAL026C-A,YAL026C,HRA1,YAL025C,YAL024C	0	0	6	6
chrI	106272	128103	WGDCluster	YAL023C,YAL022C,YAL021C,YAL020C,YAL019W-A,YAL019W,YAL018C,YAL017W,YAL016C-B,YAL016C-A,YAL016W,YAL015C	1	4	7	12
chrI	128252	130533	Complement	YAL014C,YAL013W	0	0	2	2
chrI	130801	131986	SSDCluster	YAL012W	1	0	0	1
chrI	132201	137512	Complement	YAL011W,YAL010C,YAL009W,YAL008W	0	0	4	4
chrI	137699	138347	WGDCluster	YAL007C	0	1	0	1
chrI	139504	141409	SSDCluster	YAL005C,YAL004W	2	0	0	2
chrI	142175	153878	Complement	YAL003W,YAL002W,YAL001C,YAR002W	0	0	4	4
chrI	154066	154726	WGDCluster	YAR002C-A	0	1	0	1
chrI	155006	179818	Complement	YAR003W,YAR007C,YAR008W,YAR009C,YAR010C,YAR014C,YAR015W,YAR018C,YAR019C,YAR019W-A,YAR020C,YAR023C	0	0	12	12
chrI	183763	192250	SSDCluster	YAR027W,YAR028W,YAR029W,YAR030C,YAR031W,YAR033W,YAR035W	6	0	1	7
chrI	192330	192411	Complement	YAR035C-A	0	0	1	1
chrI	192612	196179	WGDCluster	YAR042W	0	1	0	1
chrI	201459	201780	Complement	YAR047C	0	0	1	1
chrI	203393	208007	SSDCluster	YAR050W	1	0	0	1
chrI	208357	219136	Complement	YAR053W,YAR060C,YAR061W,YAR062W	0	0	4	4
chrI	220188	226854	SSDCluster	YAR064W,YAR066W,YAR068W,YAR069C,YAR070C,YAR071W	3	0	3	6
chrI	227732	229308	Complement	YAR073W,YAR075W	0	0	2	2
chrII	968	10354	Complement	YBL113W-A,YBL112C,YBL111C,YBL109W,YBL108C-A,YBL108W,YBL107W-A,YBL107C	0	0	8	8
chrII	10846	13879	WGDCluster	YBL106C	0	1	0	1
chrII	14240	24745	Complement	YBL105C,YBL104C,YBL103C,YBL102W	0	0	4	4
chrII	24945	28299	WGDCluster	YBL101C	0	1	0	1
chrII	28426	49355	Complement	YBL100W-C,YBL100W-A,YBL100W-B,YBL100C,YBL099W,YBL098W,YBL097W,YBL096C,YBL095W,YBL094C,YBL093C,YBL092W,YBL091C-A,YBL091C,YBL090W	0	0	15	15
chrII	49570	66815	WGDCluster	YBL089W,YBL088C,YBL087C,YBL086C,YBL085W	1	3	1	5
chrII	67165	69442	SSDCluster	YBL084C	1	0	0	1
chrII	69709	74692	Complement	YBL083C,YBL082C,YBL081W,YBL080C	0	0	4	4
chrII	75255	95884	WGDCluster	YBL079W,YBL078C,YBL077W,YBL076C,YBL075C,YBL074C,YBL073W,YBL072C,YBL071C-B,YBL071W-A,YBL071C,YBL070C,YBL069W,YBL068W-A,YBL068W,YBL067C	2	8	6	16
chrII	98969	105223	SSDCluster	YBL066C,YBL064C,YBL065W,YBL063W	4	0	0	4
chrII	105309	119169	WGDCluster	YBL062W,YBL061C,YBL060W,YBL059C-A,YBL059W,YBL058W,YBL057C,YBL056W,YBL055C,YBL054W	0	5	5	10
chrII	119337	132043	SSDCluster	YBL053W,YBL052C,YBL051C,YBL050W,YBL049W,YBL048W,YBL047C	3	0	4	7
chrII	132426	136369	Complement	YBL046W,YBL045C,YBL044W	0	0	3	3
chrII	136690	145034	WGDCluster	YBL043W,YBL042C,YBL041W,YBL040C,YBL039W-B,YBL039C,YBL039C-A	1	3	3	7
chrII	146189	159696	Complement	YBL038W,YBL037W,YBL036C,YBL035C,YBL034C,YBL033C	0	0	6	6
chrII	160186	161332	SSDCluster	YBL032W	1	0	0	1
chrII	161701	162718	Complement	YBL031W	0	0	1	1
chrII	163043	169379	WGDCluster	YBL030C,YBL029C-A,YBL029W,YBL028C,YBL027W	0	2	3	5
chrII	170625	171921	Complement	YBL026W,YBL025W	0	0	2	2
chrII	172536	174591	SSDCluster	YBL024W	1	0	0	1
chrII	174922	191586	Complement	YBL023C,YBL022C,YBL021C,YBL020W,YBL019W,YBL018C,YBL017C	0	0	7	7
chrII	192453	193515	SSDCluster	YBL016W	1	0	0	1
chrII	194124	203264	Complement	YBL015W,YBL014C,YBL013W	0	0	3	3
chrII	203408	212178	SSDCluster	YBL012C,YBL011W,YBL010C,YBL009W,YBL008W-A,YBL008W	3	1	2	6
chrII	212634	216863	Complement	YBL007C,YBL006C,YBL006W-A	0	0	3	3
chrII	217472	220403	WGDCluster	YBL005W	0	1	0	1
chrII	221332	235120	Complement	YBL005W-A,YBL005W-B,YBL004W	0	0	3	3
chrII	235396	242570	SSDCluster	YBL003C,YBL002W,YBL001C,YBR001C,YBR002C	3	1	1	5
chrII	242810	245669	Complement	YBR003W,YBR004C	0	0	2	2
chrII	245907	246549	WGDCluster	YBR005W	0	1	0	1
chrII	247011	254210	Complement	YBR006W,YBR007C,YBR008C	0	0	3	3
chrII	255370	257973	SSDCluster	YBR009C,YBR010W,YBR011C	3	0	0	3
chrII	259144	265879	Complement	YBR012C,YBR012W-B,YBR012W-A,YBR013C	0	0	4	4
chrII	266724	267336	WGDCluster	YBR014C	0	1	0	1
chrII	267709	291865	SSDCluster	YBR015C,YBR016W,YBR017C,YBR018C,YBR019C,YBR020W,YBR021W,YBR022W,YBR023C,YBR024W,YBR025C	4	3	4	11
chrII	292876	299950	Complement	YBR026C,YBR027C,YBR028C,YBR029C,YBR030W	0	0	5	5
chrII	300165	301254	WGDCluster	YBR031W	0	1	0	1
chrII	301518	301821	Complement	YBR032W	0	0	1	1
chrII	301943	323945	SSDCluster	YBR033W,YBR034C,YBR035C,TLC1,YBR036C,YBR037C,YBR038W,YBR039W,YBR040W,YBR041W,YBR042C,YBR043C	3	2	7	12
chrII	324336	333810	Complement	YBR044C,YBR045C,YBR046C,YBR047W,YBR048W	0	0	5	5
chrII	334383	344133	WGDCluster	YBR049C,YBR050C,YBR051W,YBR052C,YBR053C,YBR054W	0	5	1	6
chrII	344599	362512	Complement	YBR055C,YBR056W,YBR056W-A,YBR056C-B,YBR057C,YBR058C,YBR058C-A,YBR059C,YBR060C	0	0	9	9
chrII	364784	385983	SSDCluster	YBR061C,YBR062C,YBR063C,YBR064W,YBR065C,YBR066C,YBR067C,YBR068C,YBR069C,YBR070C,YBR071W,YBR072W,YBR072C-A,YBR073W	4	2	8	14
chrII	386280	392287	Complement	YBR074W,YBR076W,YBR076C-A,YBR077C	0	0	4	4
chrII	393117	394854	WGDCluster	YBR078W	0	1	0	1
chrII	395376	410623	Complement	YBR079C,YBR080C,YBR081C,YBR082C,YBR083W	0	0	5	5
chrII	411047	413975	SSDCluster	YBR084W	1	0	0	1
chrII	414179	415255	Complement	YBR084C-A	0	0	1	1
chrII	415976	427052	WGDCluster	YBR085W,YBR085C-A,YBR086C,YBR087W,YBR088C,YBR089W,YBR089C-A,YBR090C	0	3	5	8
chrII	427148	430945	SSDCluster	YBR091C,YBR092C,YBR093C	3	0	0	3
chrII	432029	449457	Complement	YBR094W,YBR095C,YBR096W,YBR097W,YBR098W,YBR099C,YBR101C,YBR102C,YBR103W,YBR103C-A	0	0	10	10
chrII	449660	450650	WGDCluster	YBR104W	0	1	0	1
chrII	450874	469614	SSDCluster	YBR105C,YBR106W,YBR107C,YBR108W,YBR109C,YBR109W-A,YBR110W,YBR111C,YBR111W-A,YBR112C,YBR113W,YBR114W	5	0	7	12
chrII	469741	473920	Complement	YBR115C	0	0	1	1
chrII	474192	482478	WGDCluster	YBR116C,YBR117C,YBR118W,YBR119W,YBR120C,YBR121C,YBR121C-A	0	5	2	7
chrII	483963	491064	Complement	YBR122C,YBR123C,YBR124W,YBR125C,YBR126C,YBR126W-A,YBR126W-B	0	0	7	7
chrII	491262	492816	SSDCluster	YBR127C	1	0	0	1
chrII	493074	505300	Complement	YBR128C,YBR129C,YBR130C,YBR131W,YBR131C-A,YBR132C,YBR133C,YBR134W,YBR135W	0	0	9	9
chrII	505661	517184	SSDCluster	YBR136W,YBR137W,YBR138C,YBR139W	2	0	2	4
chrII	517343	544487	WGDCluster	YBR140C,YBR141C,YBR141W-A,YBR142W,YBR143C,YBR144C,YBR145W,YBR146W,YBR147W,YBR148W,YBR149W,YBR150C	0	5	7	12
chrII	545021	545972	SSDCluster	YBR151W	1	0	0	1
chrII	546369	554304	Complement	YBR152W,YBR153W,YBR154C,YBR155W,YBR156C,YBR157C	0	0	6	6
chrII	556542	564565	SSDCluster	YBR158W,YBR159W,YBR160W,YBR161W,YBR162C	3	1	1	5
chrII	565225	573607	Complement	YBR162W-A,YBR163W,YBR164C,YBR165W,YBR166C,YBR167C,YBR168W	0	0	7	7
chrII	573909	597060	WGDCluster	YBR169C,YBR170C,YBR171W,YBR172C,YBR173C,YBR174C,YBR175W,YBR176W,YBR177C,YBR178W,YBR179C,YBR180W,YBR181C,YBR182C,YBR182C-A,YBR183W	1	6	9	16
chrII	597357	610404	Complement	YBR184W,YBR185C,YBR186W,YBR187W,YBR188C,YBR189W,YBR190W,YBR191W,YBR191W-A,YBR192W,YBR193C,YBR194W	0	0	12	12
chrII	610608	636538	SSDCluster	YBR195C,YBR196C,YBR196C-A,YBR196C-B,YBR197C,YBR198C,YBR199W,YBR200W,YBR200W-A,YBR201W,YBR201C-A,YBR202W,YBR203W,YBR204C,YBR205W,YBR206W,YBR207W	6	1	10	17
chrII	636697	642895	Complement	YBR208C,YBR209W	0	0	2	2
chrII	645544	662244	WGDCluster	YBR210W,YBR211C,YBR212W,YBR213W,YBR214W,YBR215W,YBR216C,YBR217W,YBR218C	1	4	4	9
chrII	662493	664672	SSDCluster	YBR219C,YBR219C,YBR220C,YBR220C	4	0	0	4
chrII	665147	683085	Complement	YBR221C,YBR221W-A,YBR222C,YBR223C,YBR223W-A,YBR224W,YBR225W,YBR226C,YBR227C,YBR228W,YBR229C,YBR230C,YBR230W-A,LSR1,YBR231C	0	0	15	15
chrII	683367	684664	SSDCluster	YBR232C,YBR233W	2	0	0	2
chrII	684971	694513	Complement	YBR233W-A,YBR234C,YBR235W,YBR236C,YBR237W	0	0	5	5
chrII	695101	697297	WGDCluster	YBR238C	0	1	0	1
chrII	698348	717989	SSDCluster	YBR239C,YBR240C,YBR241C,YBR242W,YBR243C,YBR244W,YBR245C,YBR246W,YBR247C,YBR248C,YBR249C	5	2	4	11
chrII	719027	730157	Complement	YBR250W,YBR251W,YBR252W,YBR253W,YBR254C,YBR255W,YBR255C-A,YBR256C,YBR257W,YBR258C	0	0	10	10
chrII	730381	732448	WGDCluster	YBR259W	0	1	0	1
chrII	732633	746106	SSDCluster	YBR260C,YBR261C,YBR262C,YBR263W,YBR264C,YBR265W,YBR267W,YBR266C,YBR268W,YBR269C,YBR270C,YBR271W	5	1	6	12
chrII	746355	747798	Complement	YBR272C	0	0	1	1
chrII	748055	749366	WGDCluster	YBR273C	0	1	0	1
chrII	749588	760039	Complement	YBR274W,YBR275C,YBR276C	0	0	3	3
chrII	760210	760895	WGDCluster	YBR277C,YBR278W	0	2	0	2
chrII	761252	764693	Complement	YBR279W,YBR280C	0	0	2	2
chrII	764965	811473	SSDCluster	YBR281C,YBR282W,YBR283C,YBR284W,YBR285W,YBR286W,YBR287W,YBR288C,YBR289W,YBR290W,YBR291C,YBR292C,YBR293W,YBR294W,YBR295W,YBR296C,YBR296C-A,YBR297W,YBR298C,YBR298C-A,YBR299W,YBR300C,YBR301W,YBR302C	11	1	12	24
chrIII	891	3750	Complement	YCL076W,YCL075W,YCL074W	0	0	3	3
chrIII	6478	10623	WGDCluster	YCL073C,YCL069W	0	2	0	2
chrIII	11502	14119	SSDCluster	YCL068C,YCL067C,YCL066W,YCL065W	4	0	0	4
chrIII	15797	24325	Complement	YCL064C,YCL063W,YCL061C,YCL059C,YCL058C,YCL058W-A,YCL057C-A	0	0	7	7
chrIII	24767	33974	SSDCluster	YCL057W,YCL056C,YCL055W,YCL054W	2	0	2	4
chrIII	34142	35393	Complement	YCL052C	0	0	1	1
chrIII	35864	61173	WGDCluster	YCL051W,YCL050C,YCL049C,YCL048W-A,YCL048W,YCL047C,YCL045C,YCL046W,YCL044C,YCL043C,YCL041C,YCL042W,YCL040W,YCL039W,YCL038C,YCL037C,YCL036W,YCL035C	0	10	8	18
chrIII	61657	73341	Complement	YCL034W,YCL033C,YCL032W,YCL031C,YCL030C,YCL029C,YCL028W,YCL027W	0	0	8	8
chrIII	73404	75285	SSDCluster	YCL026C-B,YCL026C-A	2	0	0	2
chrIII	76017	82085	WGDCluster	YCL025C,YCL023C,YCL024W,YCL022C	0	4	0	4
chrIII	83619	101788	Complement	YCL021W-A,YCL020W,YCL019W,YCL018W,YCL017C,YCL016C,YCL014W,YCL012C	0	0	8	8
chrIII	102074	103358	WGDCluster	YCL011C	0	1	0	1
chrIII	103570	113539	Complement	YCL010C,YCL009C,YCL008C,YCL007C,YCL005W-A,YCL005W,YCL004W,YCL002C,YCL001W,YCL001W-A	0	0	10	10
chrIII	113767	136871	WGDCluster	YCL001W-B,YCR001W,YCR002C,YCR003W,YCR004C,YCR005C,YCR006C,YCR007C,YCR008W,YCR009C,YCR010C,YCR011C	1	4	7	12
chrIII	137743	147632	Complement	YCR012W,YCR013C,YCR014C,YCR015C,YCR016W,YCR017C	0	0	6	6
chrIII	148235	148901	SSDCluster	YCR018C	1	0	0	1
chrIII	151605	160369	Complement	YCR018C-A,YCR019W,YCR020C,YCR020C-A,YCR020W-B,YCR021C,YCR022C,YCR023C	0	0	8	8
chrIII	160739	162218	SSDCluster	YCR024C	1	0	0	1
chrIII	162594	162861	Complement	YCR024C-B	0	0	1	1
chrIII	162940	166335	WGDCluster	YCR024C-A,YCR025C,YCR026C	0	2	1	3
chrIII	167365	190165	Complement	YCR027C,YCR028C,YCR028C-A,YCR030C,YCR031C,YCR032W,YCR033W	0	0	7	7
chrIII	190587	201239	SSDCluster	YCR034W,YCR035C,YCR036W,YCR037C,YCR038C,YCR038C,YCR038W-A,YCR039C,YCR039C,YCR040W,YCR041W	8	2	1	11
chrIII	201169	211503	Complement	YCR042C,YCR043C,YCR044C,YCR045C,YCR045W-A,YCR046C,YCR047C,YCR047W-A	0	0	8	8
chrIII	211866	216441	WGDCluster	YCR049C,YCR048W,YCR050C,YCR051W,YCR052W	0	4	1	5
chrIII	216692	223224	Complement	YCR053W,YCR054C,YCR057C	0	0	3	3
chrIII	223449	232959	SSDCluster	YCR059C,YCR060W,YCR061W,YCR064C,YCR063W,YCR065W,YCR066W	3	0	4	7
chrIII	233120	249199	WGDCluster	YCR067C,YCR068W,YCR069W,YCR071C,YCR072C,YCR073C,YCR073W-A,YCR075C,YCR075W-A	1	5	3	9
chrIII	249289	266843	Complement	YCR076C,YCR077C,YCR079W,YCR081W,YCR081C-A,YCR082W,YCR083W,YCR084C,YCR085W,YCR086W,YCR087W,YCR087C-A,YCR088W	0	0	13	13
chrIII	267430	276563	WGDCluster	YCR089W,YCR090C,YCR091W	0	2	1	3
chrIII	276760	279817	SSDCluster	YCR092C	1	0	0	1
chrIII	280113	286440	Complement	YCR093W	0	0	1	1
chrIII	286758	287934	WGDCluster	YCR094W	0	1	0	1
chrIII	288166	294702	Complement	YCR095C,YCR095W-A,YCR096C,YCR097W,YCR097W-A	0	0	5	5
chrIII	297045	316185	SSDCluster	YCR098C,YCR099C,YCR100C,YCR101C,YCR102C,YCR102W-A,YCR104W,YCR105W,YCR106W,YCR107W,YCR108C	4	0	7	11
chrIV	1801	18566	SSDCluster	YDL248W,YDL247W-A,YDL247W,YDL246C,YDL245C,YDL244W,YDL243C	6	0	1	7
chrIV	18958	25876	Complement	YDL242W,YDL241W,YDL240C-A,YDL240W	0	0	4	4
chrIV	26402	28775	WGDCluster	YDL239C	0	1	0	1
chrIV	28984	33918	Complement	YDL238C,YDL237W,YDL236W,YDL235C	0	0	4	4
chrIV	34237	36478	SSDCluster	YDL234C	1	0	0	1
chrIV	36797	43708	Complement	YDL233W,YDL232W,YDL231C,YDL230W	0	0	4	4
chrIV	44065	61802	WGDCluster	YDL229W,YDL228C,YDL227C,YDL226C,YDL225W,YDL224C,YDL223C,YDL222C	2	6	0	8
chrIV	62011	68607	Complement	YDL221W,YDL220C,YDL219W,YDL218W,YDL217C	0	0	5	5
chrIV	68997	70320	SSDCluster	YDL216C	1	0	0	1
chrIV	70640	73919	Complement	YDL215C	0	0	1	1
chrIV	74446	80413	WGDCluster	YDL214C,YDL213C,YDL212W,YDL211C	0	2	2	4
chrIV	84270	87227	Complement	YDL210W,YDL209C	0	0	2	2
chrIV	87512	92465	SSDCluster	YDL208W,YDL207W,YDL206W	2	0	1	3
chrIV	92762	93746	Complement	YDL205C	0	0	1	1
chrIV	94605	95787	WGDCluster	YDL204W	0	1	0	1
chrIV	96082	111030	Complement	YDL203C,YDL202W,YDL201W,YDL200C,YDL199C,YDL198C,YDL197C,YDL196W,YDL195W	0	0	9	9
chrIV	111580	145519	WGDCluster	YDL194W,YDL193W,YDL192W,YDL191W,YDL190C,YDL189W,YDL188C,YDL187C,YDL186W,YDL185C-A,YDL185W,YDL184C,YDL183C,YDL182W,YDL181W,YDL180W,YDL179W,YDL178W,YDL177C,YDL176W,YDL175C	4	8	9	21
chrIV	145826	164866	Complement	YDL174C,YDL173W,YDL172C,YDL171C,YDL170W,YDL169C,YDL168W,YDL167C,YDL166C,YDL165W	0	0	10	10
chrIV	164987	167259	SSDCluster	YDL164C,YDL163W	2	0	0	2
chrIV	167359	178057	WGDCluster	YDL162C,YDL161W,YDL160C-A,YDL160C,YDL159W-A,YDL159W,YDL159C-B,YDL158C,YDL157C,YDL156W,YDL155W	0	3	8	11
chrIV	178334	194226	Complement	YDL154W,YDL153C,YDL152W,YDL151C,YDL150W,YDL149W,YDL148C,YDL147W,YDL146W	0	0	9	9
chrIV	194571	210562	SSDCluster	YDL145C,YDL144C,YDL143W,YDL142C,YDL141W,YDL140C	3	0	3	6
chrIV	211375	212047	Complement	YDL139C	0	0	1	1
chrIV	213351	235853	WGDCluster	YDL138W,YDL137W,YDL136W,YDL135C,YDL134C,YDL133C-A,YDL133W,YDL132W,YDL131W,YDL130W-A,YDL130W,YDL129W,YDL128W,YDL127W	2	8	4	14
chrIV	236156	239606	SSDCluster	YDL126C,YDL125C	2	0	0	2
chrIV	240258	255048	Complement	YDL124W,YDL123W,YDL122W,YDL121C,YDL120W,YDL119C,YDL118W,YDL117W,YDL116W,YDL115C,YDL114W-A	0	0	11	11
chrIV	255603	258555	SSDCluster	YDL114W,YDL113C	2	0	0	2
chrIV	258914	264964	Complement	YDL112W,YDL111C,YDL110C	0	0	3	3
chrIV	265257	267201	WGDCluster	YDL109C	0	1	0	1
chrIV	267697	273597	Complement	YDL108W,YDL107W,YDL106C,YDL105W	0	0	4	4
chrIV	273652	296329	SSDCluster	YDL104C,YDL103C,YDL102W,YDL101C,YDL100C,YDL099W,YDL098C,YDL097C,YDL096C,YDL095W,YDL094C,YDL093W,YDL092W,YDL091C,YDL090C	7	0	8	15
chrIV	296819	298274	Complement	YDL089W	0	0	1	1
chrIV	298416	307789	WGDCluster	YDL088C,YDL087C,YDL086W,YDL086C-A,YDL085C-A,YDL085W,YDL084W,YDL083C	0	3	5	8
chrIV	308423	309388	Complement	YDL082W	0	0	1	1
chrIV	309801	316388	SSDCluster	YDL081C,YDL080C,YDL079C,YDL078C	2	0	2	4
chrIV	316970	330447	Complement	YDL077C,YDL076C,YDL075W,YDL074C,YDL073W,YDL072C	0	0	6	6
chrIV	330666	340798	WGDCluster	YDL071C,YDL070W,YDL069C,YDL068W,YDL067C,YDL066W,YDL065C,YDL064W,YDL063C,YDL062W,YDL061C	0	3	8	11
chrIV	341618	365874	SSDCluster	YDL060W,YDL059C,YDL058W,YDL057W,YDL056W,YDL055C,YDL054C,YDL053C,YDL052C,YDL051W,YDL050C,YDL049C	4	0	8	12
chrIV	366738	388899	WGDCluster	YDL048C,YDL047W,YDL046W,YDL045W-A,YDL045C,YDL044C,YDL043C,YDL042C,YDL041W,YDL040C,YDL039C,YDL037C,YDL036C	1	4	8	13
chrIV	389169	405058	Complement	YDL035C,YDL034W,YDL033C,YDL032W,YDL031W,YDL030W,YDL029W,YDL028C,YDL027C,YDL026W	0	0	10	10
chrIV	405341	405512	SSDCluster	YDL025C,YDL025W-A	2	0	0	2
chrIV	408448	410054	Complement	YDL024C,YDL022C-A	0	0	2	2
chrIV	411758	421512	WGDCluster	YDL023C,YDL022W,YDL021W,YDL020C,YDL019C	0	4	1	5
chrIV	422830	431515	Complement	YDL018C,YDL017W,YDL016C,YDL015C,YDL014W,YDL013W,YDL012C	0	0	7	7
chrIV	432305	433246	WGDCluster	YDL011C,YDL010W,YDL009C	0	3	0	3
chrIV	433494	436822	Complement	YDL008W,YDL007C-A	0	0	2	2
chrIV	438044	449274	SSDCluster	YDL007W,YDL006W,YDL005C,YDL004W,YDL003W,YDL002C,YDL001W	2	0	5	7
chrIV	450217	509107	WGDCluster	YDR001C,YDR002W,YDR003W,YDR003W-A,YDR004W,YDR005C,YDR006C,YDR007W,YDR008C,YDR009W,YDR010C,YDR011W,YDR012W,YDR013W,YDR014W,YDR014W-A,YDR015C,YDR016C,YDR017C,YDR018C,YDR019C,YDR020C,YDR021W,YDR022C,YDR023W,YDR024W,YDR025W,YDR026C,YDR027C,YDR028C,YDR029W,YDR030C,YDR031W,YDR032C,YDR033W	2	10	23	35
chrIV	509734	521467	Complement	YDR034C,YDR034C-D,YDR034C-C,YDR034C-A,YDR034W-B	0	0	5	5
chrIV	521813	534580	SSDCluster	YDR035W,YDR036C,YDR037W,YDR038C,YDR039C	4	0	1	5
chrIV	535189	541201	Complement	YDR040C,YDR041W,YDR042C	0	0	3	3
chrIV	542672	550575	WGDCluster	YDR043C,YDR044W,YDR045C,YDR046C	0	2	2	4
chrIV	551858	562326	Complement	YDR047W,YDR048C,YDR049W,YDR050C,YDR051C,YDR052C,YDR053W,YDR054C	0	0	8	8
chrIV	563525	569769	WGDCluster	YDR055W,YDR056C,YDR057W,YDR058C,YDR059C	0	2	3	5
chrIV	570646	575781	Complement	YDR060W,YDR061W	0	0	2	2
chrIV	576471	578157	SSDCluster	YDR062W	1	0	0	1
chrIV	578661	581783	Complement	YDR063W,YDR064W,YDR065W	0	0	3	3
chrIV	581906	587718	WGDCluster	YDR066C,YDR067C,YDR068W,YDR069C	0	2	2	4
chrIV	588096	589401	Complement	YDR070C,YDR071C	0	0	2	2
chrIV	589759	591343	SSDCluster	YDR072C	1	0	0	1
chrIV	592436	599686	Complement	YDR073W,YDR074W,YDR075W,YDR076W	0	0	4	4
chrIV	600790	601807	WGDCluster	YDR077W	0	1	0	1
chrIV	602195	614002	Complement	YDR078C,YDR079W,YDR079C-A,YDR080W,YDR081C,YDR082W,YDR083W,YDR084C	0	0	8	8
chrIV	614285	616148	WGDCluster	YDR085C	0	1	0	1
chrIV	616925	630603	Complement	YDR086C,YDR087C,YDR088C,YDR089W,YDR090C,YDR091C,YDR092W	0	0	7	7
chrIV	631279	654426	WGDCluster	YDR093W,YDR094W,YDR095C,YDR096W,YDR097C,YDR098C,YDR098C-B,YDR098C-A,YDR099W	1	6	2	9
chrIV	655010	667856	Complement	YDR100W,YDR101C,YDR102C,YDR103W,YDR104C,YDR105C,YDR106W	0	0	7	7
chrIV	669013	679850	WGDCluster	YDR107C,YDR108W,YDR109C,YDR110W,YDR111C,YDR112W	1	3	2	6
chrIV	680493	694173	Complement	YDR113C,YDR114C,YDR115W,YDR116C,YDR117C,YDR118W,YDR118W-A,YDR119W,YDR119W-A,YDR120C,YDR121W	0	0	11	11
chrIV	694697	702756	WGDCluster	YDR122W,YDR123C,YDR124W,YDR125C	0	2	2	4
chrIV	703231	727549	SSDCluster	YDR126W,YDR127W,YDR128W,YDR129C,YDR130C,YDR131C,YDR132C,YDR133C,YDR134C,YDR135C	4	1	5	10
chrIV	727708	743872	Complement	YDR136C,YDR137W,YDR138W,YDR139C,YDR140W,YDR141C,YDR142C,YDR143C	0	0	8	8
chrIV	744308	753233	WGDCluster	YDR144C,YDR145W,YDR146C,YDR147W	0	3	1	4
chrIV	753672	755064	SSDCluster	YDR148C	1	0	0	1
chrIV	755552	763872	Complement	YDR149C,YDR150W	0	0	2	2
chrIV	764175	765153	WGDCluster	YDR151C	0	1	0	1
chrIV	765703	767969	Complement	YDR152W,YDR153C	0	0	2	2
chrIV	768400	768998	SSDCluster	YDR154C,YDR155C	2	0	0	2
chrIV	769522	804515	Complement	YDR156W,YDR157W,YDR158W,YDR159W,YDR160W,YDR161W,YDR162C,YDR163W,YDR164C,YDR165W,YDR166C,YDR167W,YDR168W,YDR169C,YDR169C-A,YDR170C,YDR170W-A	0	0	17	17
chrIV	806618	807746	SSDCluster	YDR171W	1	0	0	1
chrIV	808321	817523	Complement	YDR172W,YDR173C,YDR174W,YDR175C,YDR176W,YDR177W	0	0	6	6
chrIV	817947	818493	WGDCluster	YDR178W	0	1	0	1
chrIV	818705	829055	Complement	YDR179C,YDR179W-A,YDR180W,YDR181C,YDR182W	0	0	5	5
chrIV	829148	852395	SSDCluster	YDR182W-A,YDR183W,YDR183C-A,YDR184C,YDR185C,YDR186C,YDR187C,YDR188W,YDR189W,YDR190C,YDR191W,YDR192C,YDR193W,YDR194C,YDR194W-A,YDR195W,YDR196C,YDR197W	7	1	10	18
chrIV	852530	853970	Complement	YDR198C	0	0	1	1
chrIV	854172	864706	WGDCluster	YDR199W,YDR200C,YDR201W,YDR202C,YDR203W,YDR204W,YDR205W,YDR206W	0	3	5	8
chrIV	865009	883925	Complement	YDR207C,YDR208W,YDR209C,YDR210W,YDR210W-B,YDR210W-A,YDR210C-D,YDR210C-C	0	0	8	8
chrIV	884724	893925	SSDCluster	YDR211W,YDR212W,YDR213W,YDR214W	2	1	1	4
chrIV	894115	909435	Complement	YDR215C,YDR216W,YDR217C,YDR218C,YDR219C,YDR220C,YDR221W	0	0	7	7
chrIV	910050	913499	WGDCluster	YDR222W,YDR223W	0	2	0	2
chrIV	914313	917151	SSDCluster	YDR224C,YDR225W,YDR226W	3	0	0	3
chrIV	917567	926907	Complement	YDR227W,YDR228C,YDR229W,YDR230W,YDR231C	0	0	5	5
chrIV	927448	953978	SSDCluster	YDR232W,YDR233C,YDR234W,YDR235W,YDR236C,YDR237W,YDR238C,YDR239C,YDR240C,YDR241W,YDR242W,YDR243C,YDR244W,YDR245W	6	1	7	14
chrIV	954284	955330	Complement	YDR246W,YDR246W-A	0	0	2	2
chrIV	956009	964562	WGDCluster	YDR247W,YDR248C,YDR249C,YDR250C,YDR251W,YDR252W,YDR253C	0	4	3	7
chrIV	965109	967819	Complement	YDR254W,YDR255C	0	0	2	2
chrIV	968129	974240	SSDCluster	YDR256C,YDR257C,YDR258C	2	0	1	3
chrIV	974627	975779	WGDCluster	YDR259C	0	1	0	1
chrIV	976713	993949	Complement	YDR260C,YDR261C,YDR261W-B,YDR261W-A,YDR261C-D,YDR261C-C,YDR262W	0	0	7	7
chrIV	994238	998320	WGDCluster	YDR263C,YDR264C	0	2	0	2
chrIV	998860	1005140	Complement	YDR265W,YDR266C,YDR267C,YDR268W	0	0	4	4
chrIV	1005661	1008763	SSDCluster	YDR269C,YDR270W,YDR271C	3	0	0	3
chrIV	1009006	1015699	WGDCluster	YDR272W,YDR273W,YDR274C,YDR275W,YDR276C,YDR277C	0	3	3	6
chrIV	1016997	1024752	Complement	YDR278C,YDR279W,YDR280W,YDR281C,YDR282C	0	0	5	5
chrIV	1025066	1057597	SSDCluster	YDR283C,YDR284C,YDR285W,YDR286C,YDR287W,YDR288W,YDR289C,YDR290W,YDR291W,YDR292C,YDR293C,YDR294C,YDR295C,YDR296W,YDR297W	8	0	7	15
chrIV	1058172	1061228	Complement	YDR298C,YDR299W	0	0	2	2
chrIV	1061501	1088940	WGDCluster	YDR300C,YDR301W,YDR302W,YDR303C,YDR304C,YDR305C,YDR306C,YDR307W,YDR308C,YDR309C,YDR310C,YDR311W,YDR312W	0	5	8	13
chrIV	1089216	1090077	Complement	YDR313C	0	0	1	1
chrIV	1090430	1092509	SSDCluster	YDR314C	1	0	0	1
chrIV	1092738	1120229	Complement	YDR315C,YDR316W,YDR316W-B,YDR316W-A,YDR317W,YDR318W,YDR319C,YDR320C,YDR320C-A,YDR320W-B,YDR321W,YDR322W,YDR322C-A,YDR323C,YDR324C,YDR325W	0	0	16	16
chrIV	1120604	1124921	WGDCluster	YDR326C	0	1	0	1
chrIV	1125297	1135427	Complement	YDR327W,YDR328C,YDR329C,YDR330W,YDR331W,YDR332W,YDR333C	0	0	7	7
chrIV	1135927	1155923	SSDCluster	YDR334W,YDR335W,YDR336W,YDR337W,YDR338C,YDR339C,YDR340W,YDR341C,YDR342C	4	1	4	9
chrIV	1159602	1191726	WGDCluster	YDR343C,YDR344C,YDR345C,YDR346C,YDR347W,YDR348C,YDR349C,YDR350C,YDR351W,YDR352W,YDR353W,YDR354W,YDR354C-A,YDR355C,YDR356W,YDR357C,YDR358W	1	6	10	17
chrIV	1191929	1213607	Complement	YDR359C,YDR360W,YDR361C,YDR362C,YDR363W,YDR363W-A,YDR364C,YDR365C,YDR365W-A,YDR365W-B,YDR366C,YDR367W	0	0	12	12
chrIV	1213896	1214835	WGDCluster	YDR368W	0	1	0	1
chrIV	1215008	1222142	Complement	YDR369C,YDR370C,YDR371W,YDR371C-A,YDR372C	0	0	5	5
chrIV	1222751	1223324	SSDCluster	YDR373W	1	0	0	1
chrIV	1223466	1229602	Complement	YDR374C,YDR374W-A,YDR375C,YDR376W,YDR377W,YDR378C	0	0	6	6
chrIV	1230159	1233189	WGDCluster	YDR379W	0	1	0	1
chrIV	1233270	1238843	Complement	YDR379C-A,YDR380W,YDR381W,YDR381C-A	0	0	4	4
chrIV	1239484	1239817	SSDCluster	YDR382W	1	0	0	1
chrIV	1239952	1242024	Complement	YDR383C,YDR384C	0	0	2	2
chrIV	1243222	1254494	WGDCluster	YDR385W,YDR386W,YDR387C,YDR388W,YDR389W	0	2	3	5
chrIV	1254929	1277162	SSDCluster	YDR390C,YDR391C,YDR392W,YDR393W,YDR394W,YDR395W,YDR396W,YDR397C,YDR398W,YDR399W,YDR400W,YDR401W,YDR402C,YDR403W,YDR404C	5	0	10	15
chrIV	1277638	1278430	Complement	YDR405W	0	0	1	1
chrIV	1279202	1302106	WGDCluster	YDR406W,YDR406W-A,YDR407C,YDR408C,YDR409W,YDR410C,YDR411C,YDR412W,YDR413C,YDR414C,YDR415C,YDR416W,YDR417C,YDR418W	1	5	8	14
chrIV	1303166	1333962	SSDCluster	YDR419W,YDR420W,YDR421W,YDR422C,YDR423C,YDR424C,YDR425W,YDR426C,YDR427W,YDR428C,YDR429C,YDR430C,YDR431W,YDR432W,YDR433W,YDR434W,YDR435C	6	1	10	17
chrIV	1334813	1345055	WGDCluster	YDR436W,YDR437W,YDR438W,YDR439W,YDR440W,YDR441C	0	3	3	6
chrIV	1345639	1358895	Complement	YDR442W,YDR443C,YDR444W,YDR445C,YDR446W,YDR447C,YDR448W,YDR449C	0	0	8	8
chrIV	1359915	1365655	WGDCluster	YDR450W,YDR451C,YDR452W,YDR453C	0	3	1	4
chrIV	1366256	1369379	Complement	YDR454C,YDR455C,YDR456W	0	0	3	3
chrIV	1369782	1379589	SSDCluster	YDR457W	1	0	0	1
chrIV	1380047	1388368	WGDCluster	YDR458C,YDR459C,YDR460W,YDR461W,YDR461C-A,YDR462W,YDR463W	1	2	4	7
chrIV	1388864	1401207	Complement	YDR464W,YDR464C-A,YDR465C,YDR466W,YDR467C,YDR468C,YDR469W,YDR470C	0	0	8	8
chrIV	1401762	1497761	WGDCluster	YDR471W,YDR472W,YDR473C,YDR475C,YDR476C,YDR477W,YDR478W,YDR479C,YDR480W,YDR481C,YDR482C,YDR483W,YDR484W,YDR485C,YDR486C,YDR487C,YDR488C,YDR489W,YDR490C,YDR491C,YDR492W,YDR493W,YDR494W,YDR495C,YDR496C,YDR497C,YDR498C,YDR499W,YDR500C,YDR501W,YDR502C,YDR503C,YDR504C,YDR505C,YDR506C,YDR507C,YDR508C,YDR509W,YDR510W,YDR510C-A,YDR511W,YDR512C,YDR513W,YDR514C,YDR515W,YDR516C,YDR517W,YDR518W,YDR519W,YDR520C,YDR521W,YDR522C,YDR523C,YDR524C,YDR524W-C,YDR524C-B,YDR524C-A,YDR525W,YDR525W-A,YDR526C,YDR527W,YDR528W,YDR529C,YDR530C	5	23	36	64
chrIV	1498224	1502153	Complement	YDR531W,YDR532C,YDR533C	0	0	3	3
chrIV	1503305	1504892	SSDCluster	YDR534C	1	0	0	1
chrIV	1506597	1517660	Complement	YDR535C,YDR536W,YDR537C,YDR538W,YDR539W,YDR540C	0	0	6	6
chrIV	1519648	1520683	SSDCluster	YDR541C	1	0	0	1
chrIV	1523234	1531328	Complement	YDR542W,YDR543C,YDR544C,YDR545W,YDR545C-A	0	0	5	5
chrV	263	1612	Complement	YEL077C,YEL077W-A	0	0	2	2
chrV	4184	5713	SSDCluster	YEL076C-A,YEL076C,YEL075W-A,YEL075W-A,YEL075C	5	0	0	5
chrV	6125	14415	Complement	YEL074W,YEL073C,YEL072W	0	0	3	3
chrV	16354	48373	SSDCluster	YEL071W,YEL070W,YEL069C,YEL068C,YEL067C,YEL066W,YEL065W,YEL064C,YEL063C,YEL062W,YEL061C,YEL060C,YEL059C-A,YEL059W,YEL058W,YEL057C,YEL056W	7	2	8	17
chrV	48470	51539	Complement	YEL055C	0	0	1	1
chrV	52720	53255	WGDCluster	YEL054C,YEL053W-A	0	2	0	2
chrV	53900	60851	Complement	YEL053C,YEL052W,YEL051W,YEL050W-A,YEL050C	0	0	5	5
chrV	63727	64090	SSDCluster	YEL049W	1	0	0	1
chrV	64708	65167	Complement	YEL048C	0	0	1	1
chrV	65384	126218	WGDCluster	YEL047C,YEL046C,YEL045C,YEL044W,YEL043W,YEL042W,YEL041W,YEL040W,YEL039C,YEL038W,YEL037C,YEL036C,YEL035C,YEL034C-A,YEL034W,YEL033W,YEL032W,YEL032C-A,YEL031W,YEL030C-A,YEL030W,YEL029C,YEL028W,YEL027W,YEL026W,YEL025C,YEL024W,YEL023C,YEL022W,YEL021W,YEL020C-B,YEL020W-A,RPR1,YEL020C,YEL019C,YEL018C-A,YEL018W,YEL017C-A,YEL017W,YEL016C	8	11	21	40
chrV	126628	128608	Complement	YEL015W,YEL014C	0	0	2	2
chrV	128824	130561	SSDCluster	YEL013W	1	0	0	1
chrV	131771	140818	Complement	YEL012W,YEL011W,YEL010W,YEL009C-A,YEL009C,YEL008W,YEL008C-A	0	0	7	7
chrV	141890	155807	WGDCluster	YEL007W,YEL006W,YEL005C,YEL004W,YEL003W,YEL002C,YEL001C,YER001W	0	3	5	8
chrV	156801	160274	Complement	YER002W,YER003C,YER004W	0	0	3	3
chrV	160548	164284	SSDCluster	YER005W,YER006W	2	0	0	2
chrV	164342	173337	Complement	YER006C-A,YER007W,YER007C-A,YER008C,YER009W,YER010C	0	0	6	6
chrV	175246	204962	SSDCluster	YER011W,YER012W,YER013W,YER014W,YER014C-A,YER015W,YER016W,YER017C,YER018C,YER019W,YER019C-A,YER020W,YER021W,YER022W,YER023W,YER023C-A,YER024W	6	0	11	17
chrV	205249	208473	Complement	YER025W,YER026C	0	0	2	2
chrV	208977	229204	WGDCluster	YER027C,YER028C,YER029C,YER030W,YER031C,YER032W,YER033C,YER034W,YER035W,YER036C,YER037W,YER038C,YER038W-A,YER039C	1	7	6	14
chrV	229261	229480	Complement	YER039C-A	0	0	1	1
chrV	229793	231986	SSDCluster	YER040W	1	0	0	1
chrV	232459	239773	Complement	YER041W,YER042W,YER043C,YER044C,YER044C-A	0	0	5	5
chrV	240030	241500	WGDCluster	YER045C	0	1	0	1
chrV	243178	243610	Complement	YER046W	0	0	1	1
chrV	243698	248156	SSDCluster	YER046W-A,YER047C,YER048C	3	0	0	3
chrV	250716	257957	Complement	YER048W-A,YER049W,YER050C,YER051W,YER052C	0	0	5	5
chrV	258735	261045	SSDCluster	YER053C,YER053C-A	1	0	1	2
chrV	262050	301614	WGDCluster	YER054C,YER055C,YER056C,YER056C-A,YER057C,YER058W,YER059W,YER060W,YER060W-A,YER061C,YER062C,YER063W,YER064C,YER065C,YER066W,YER066C-A,YER067W,YER067C-A,YER068W,YER068C-A,YER069W,YER070W	4	9	9	22
chrV	301944	303193	Complement	YER071C,YER072W	0	0	2	2
chrV	304026	318338	SSDCluster	YER073W,YER074W,YER074W-A,YER075C,YER076C,YER076W-A,YER077C,YER078C	3	0	5	8
chrV	318641	321842	Complement	YER078W-A,YER079W,YER079C-A,YER080W	0	0	4	4
chrV	322207	337336	WGDCluster	SRG1,YER081W,YER082C,YER083C,YER084W,YER084W-A,YER085C,YER086W,YER087W,YER087C-A,YER087C-B,YER088C,YER088C-A,YER088W-B,YER089C	2	6	7	15
chrV	337944	347608	Complement	YER090W,YER090C-A,YER091C,YER091C-A,YER092W,YER093C	0	0	6	6
chrV	347907	372009	WGDCluster	YER093C-A,YER094C,YER095W,YER096W,YER097W,YER098W,YER099C,YER100W,YER101C,YER102W,YER103W,YER104W,YER105C	2	9	2	13
chrV	372321	373230	Complement	YER106W	0	0	1	1
chrV	373443	385872	SSDCluster	YER107C,YER107W-A,YER109C,YER110C,YER111C	4	0	1	5
chrV	387227	390048	Complement	YER112W,YER113C	0	0	2	2
chrV	390585	401865	WGDCluster	YER114C,YER115C,YER116C,YER117W,YER118C,YER119C,YER119C-A,YER120W	0	5	3	8
chrV	402370	409059	Complement	YER121W,YER122C,YER123W,YER124C	0	0	4	4
chrV	410184	412614	SSDCluster	YER125W	1	0	0	1
chrV	413389	416466	Complement	YER126C,YER127W,YER128W	0	0	3	3
chrV	417276	430445	WGDCluster	YER129W,YER130C,YER131W,YER132C	0	3	1	4
chrV	432490	438340	Complement	YER133W,YER133W-A,YER134C,YER135C	0	0	4	4
chrV	439611	440967	SSDCluster	YER136W	1	0	0	1
chrV	441368	449574	Complement	YER137C,YER137W-A,SCR1,YER138C,YER137C-A,YER138W-A	0	0	6	6
chrV	450557	468811	WGDCluster	YER139C,YER140W,YER141W,YER142C,YER143W,YER144C,YER145C,YER145C-A,YER146W,YER147C,YER147C-A,YER148W,YER148W-A,YER149C,YER150W	1	3	11	15
chrV	469680	476223	Complement	YER151C,YER152C,YER152W-A,YER153C,YER154W	0	0	5	5
chrV	476339	482843	SSDCluster	YER155C	1	0	0	1
chrV	483319	487188	Complement	YER156C,YER157W	0	0	2	2
chrV	488851	490573	WGDCluster	YER158C	0	1	0	1
chrV	491481	500343	Complement	YER158W-A,YER159C,YER160C,YER159C-A,YER161C	0	0	5	5
chrV	500624	502889	SSDCluster	YER162C	1	0	0	1
chrV	503078	512101	Complement	YER163C,YER164W,YER165W	0	0	3	3
chrV	512621	525754	WGDCluster	YER165C-A,YER166W,YER167W,YER168C,YER169W	0	3	2	5
chrV	525968	545050	SSDCluster	YER170W,YER171W,YER172C,YER172C-A,YER173W,YER174C,YER175C,YER175W-A,YER176W	5	1	3	9
chrV	545605	546409	WGDCluster	YER177W	0	1	0	1
chrV	546811	558675	Complement	YER178W,YER179W,YER180C,YER180C-A,YER181C,YER182W,YER183C,YER184C	0	0	8	8
chrV	559448	560360	SSDCluster	YER185W	1	0	0	1
chrV	561699	569902	Complement	YER186C,YER187W,YER188W,YER188C-A	0	0	4	4
chrV	571149	576520	SSDCluster	YER189W,YER190W	2	0	0	2
chrV	574798	576157	Complement	YER190C-A,YER190C-B	0	0	2	2
chrVI	52	5521	Complement	YFL068W,YFL067W,YFL066C,YFL065C,YFL064C,YFL063W	0	0	6	6
chrVI	6425	38674	SSDCluster	YFL062W,YFL060C,YFL061W,YFL059W,YFL058W,YFL057C,YFL056C,YFL055W,YFL054C,YFL053W,YFL052W,YFL051C,YFL050C,YFL049W	7	2	5	14
chrVI	38842	47744	WGDCluster	YFL048C,YFL047W,YFL046W,YFL045C,YFL044C,YFL042C	0	2	4	6
chrVI	48733	48925	Complement	YFL041W-A	0	0	1	1
chrVI	49138	63992	SSDCluster	YFL041W,YFL040W,YFL039C,YFL038C,YFL037W,RUF21,YFL036W,YFL034C-B	4	0	4	8
chrVI	64241	64931	WGDCluster	YFL034C-A	0	1	0	1
chrVI	65474	93374	Complement	YFL034W,YFL033C,YFL032W,YFL031W,YFL031C-A,YFL030W,YFL029C,YFL028C,YFL027C,YFL026W,YFL025C,YFL024C,YFL023W	0	0	13	13
chrVI	93496	130976	SSDCluster	YFL022C,YFL021C-A,YFL021W,YFL020C,YFL019C,YFL018C,YFL017W-A,YFL017C,YFL016C,YFL015W-A,YFL015C,YFL014W,YFL013W-A,YFL013C,YFL012W-A,YFL012W,YFL011W,YFL010W-A,YFL010C,YFL009W,YFL008W,YFL007W,YFL005W	8	1	14	23
chrVI	131055	131498	Complement	RUF20	0	0	1	1
chrVI	131804	134291	WGDCluster	YFL004W	0	1	0	1
chrVI	134515	153119	Complement	YFL003C,YFL002W-B,YFL002W-A,YFL002C,YFL001W,YFR001W,YFR002W,YFR003C	0	0	8	8
chrVI	153387	164126	SSDCluster	YFR004W,YFR005C,YFR006W,YFR007W,YFR008W,YFR009W,YFR009W-A	4	0	3	7
chrVI	165059	167251	Complement	YFR010W,YFR010W-A,YFR011C	0	0	3	3
chrVI	167880	182849	WGDCluster	YFR012W,YFR012W-A,YFR013W,YFR014C,YFR015C,YFR016C,YFR017C	0	5	2	7
chrVI	183118	193424	Complement	YFR018C,YFR019W,YFR020W	0	0	3	3
chrVI	194799	196302	SSDCluster	YFR021W	1	0	0	1
chrVI	196820	201697	WGDCluster	YFR022W,RUF22,YFR023W	0	2	1	3
chrVI	201947	212961	Complement	YFR024C-A,YFR025C,YFR026C,YFR027W,YFR028C,YFR029W	0	0	6	6
chrVI	213299	229173	SSDCluster	YFR030W,YFR031C,YFR031C-A,RUF23,YFR032C,YFR032C-A,YFR032C-B,YFR033C,YFR034C,YFR034W-A,YFR035C,YFR036W,YFR036W-A,YFR037C	4	1	9	14
chrVI	229366	231928	Complement	YFR038W	0	0	1	1
chrVI	231998	237237	WGDCluster	YFR039C,YFR040W	0	2	0	2
chrVI	237354	239814	Complement	YFR041C,YFR042W,YFR043C	0	0	3	3
chrVI	239978	248121	SSDCluster	YFR044C,YFR045W,YFR046C,YFR047C,YFR048W	2	0	3	5
chrVI	248509	253316	Complement	YFR049W,YFR050C,YFR051C,YFR052W	0	0	4	4
chrVI	253415	255036	WGDCluster	YFR052C-A,YFR053C	0	2	0	2
chrVI	258841	269503	Complement	YFR054C,YFR056C,YFR055W,YFR057W	0	0	4	4
chrVII	2789	5839	Complement	YGL263W,YGL262W	0	0	2	2
chrVII	6289	22108	SSDCluster	YGL261C,YGL260W,YGL259W,YGL258W-A,YGL258W,YGL257C,YGL256W,YGL255W	4	0	4	8
chrVII	22303	23203	Complement	YGL254W	0	0	1	1
chrVII	23934	25395	WGDCluster	YGL253W	0	1	0	1
chrVII	25717	36762	Complement	YGL252C,YGL251C,YGL250W,YGL249W,YGL248W	0	0	5	5
chrVII	36932	41149	SSDCluster	YGL247W,YGL246C,YGL245W	2	0	1	3
chrVII	41497	64215	Complement	YGL244W,YGL243W,YGL242C,YGL241W,YGL240W,YGL239C,YGL238W,YGL237C,YGL236C,YGL235W,YGL234W,YGL233W,YGL232W,YGL231C,YGL230C	0	0	15	15
chrVII	64502	81185	WGDCluster	YGL229C,YGL228W,YGL227W,YGL226C-A,YGL226W,YGL225W,YGL224C,YGL223C,YGL222C	0	5	4	9
chrVII	81424	84299	Complement	YGL221C,YGL220W,YGL219C,YGL218W	0	0	4	4
chrVII	84837	87301	SSDCluster	YGL217C,YGL216W	2	0	0	2
chrVII	87979	93595	Complement	YGL215W,YGL214W,YGL213C,YGL212W,YGL211W	0	0	5	5
chrVII	93796	98589	WGDCluster	YGL210W,YGL209W,YGL208W	0	3	0	3
chrVII	98972	114668	Complement	YGL207W,YGL206C,YGL205W,YGL204C,YGL203C	0	0	5	5
chrVII	116062	117565	SSDCluster	YGL202W	1	0	0	1
chrVII	117857	124303	Complement	YGL201C,YGL200C,YGL199C,YGL198W	0	0	4	4
chrVII	124702	129166	WGDCluster	YGL197W	0	1	0	1
chrVII	129887	139967	Complement	YGL196W,YGL195W,YGL194C-A	0	0	3	3
chrVII	140373	141732	SSDCluster	YGL194C	1	0	0	1
chrVII	141921	147395	Complement	YGL193C,YGL192W,YGL191W,YGL190C	0	0	4	4
chrVII	148234	148594	WGDCluster	YGL189C	0	1	0	1
chrVII	148829	152782	Complement	YGL188C-A,YGL188C,YGL187C,YGL186C	0	0	4	4
chrVII	153172	156018	SSDCluster	YGL185C,YGL184C	2	0	0	2
chrVII	156548	162764	Complement	YGL183C,YGL182C,YGL181W,YGL180W	0	0	4	4
chrVII	163414	165097	WGDCluster	YGL179C	0	1	0	1
chrVII	167357	175351	Complement	YGL178W,YGL177W,YGL176C,YGL175C,YGL174W	0	0	5	5
chrVII	175532	180119	SSDCluster	YGL173C	1	0	0	1
chrVII	180705	190474	Complement	YGL172W,YGL171W,YGL170C,YGL169W,YGL168W,YGL167C	0	0	6	6
chrVII	191134	208576	WGDCluster	YGL166W,YGL165C,YGL164C,YGL163C,YGL162W,YGL161C,YGL160W,YGL159W,YGL158W	2	4	3	9
chrVII	209010	210054	SSDCluster	YGL157W	1	0	0	1
chrVII	210420	220927	Complement	YGL156W,YGL155W,YGL154C,YGL153W,YGL152C,YGL151W	0	0	6	6
chrVII	221108	228334	SSDCluster	YGL150C,YGL149W,YGL148W,YGL147C	3	0	1	4
chrVII	228755	232353	Complement	YGL146C,YGL145W	0	0	2	2
chrVII	232454	234512	WGDCluster	YGL144C	0	1	0	1
chrVII	234721	245017	Complement	YGL143C,YGL142C,YGL141W,YGL140C	0	0	4	4
chrVII	245720	261506	WGDCluster	YGL139W,YGL138C,YGL137W,YGL136C,YGL135W,YGL134W,YGL133W	0	4	3	7
chrVII	261584	291644	SSDCluster	YGL132W,YGL131C,YGL130W,YGL129C,YGL128C,YGL127C,YGL126W,YGL125W,YGL124C,YGL123W,YGL123C-A,YGL122C,YGL121C,YGL120C,YGL119W,YGL118C,YGL117W,YGL116W	5	0	13	18
chrVII	292035	304074	Complement	YGL115W,YGL114W,YGL113W,YGL112C,YGL111W,YGL110C,YGL109W,YGL108C	0	0	8	8
chrVII	304335	312843	WGDCluster	YGL107C,YGL106W,YGL105W,YGL104C,YGL103W,YGL102C,YGL101W	0	3	4	7
chrVII	313236	314286	SSDCluster	YGL100W	1	0	0	1
chrVII	314633	323233	Complement	YGL099W,YGL098W,YGL097W	0	0	3	3
chrVII	325333	326164	WGDCluster	YGL096W	0	1	0	1
chrVII	328876	330610	SSDCluster	YGL095C	1	0	0	1
chrVII	331120	341862	Complement	YGL094C,YGL093W,YGL092W	0	0	3	3
chrVII	342058	343045	SSDCluster	YGL091C	1	0	0	1
chrVII	343321	344587	Complement	YGL090W	0	0	1	1
chrVII	344793	365999	WGDCluster	YGL089C,YGL088W,YGL087C,YGL086W,YGL085W,YGL084C,YGL083W,YGL082W,YGL081W,YGL080W,YGL079W,YGL078C,YGL077C,YGL076C	1	4	9	14
chrVII	366927	368091	Complement	YGL075C	0	0	1	1
chrVII	368598	381274	SSDCluster	YGL074C,YGL073W,YGL072C,YGL071W,YGL070C,YGL069C,YGL068W,YGL067W,YGL066W,YGL065C	4	1	5	10
chrVII	381525	383211	Complement	YGL064C	0	0	1	1
chrVII	383656	409607	WGDCluster	YGL063W,YGL063C-A,YGL062W,YGL061C,YGL060W,YGL059W,YGL058W,YGL057C,YGL056C,YGL055W,YGL054C,YGL053W,YGL052W,YGL051W,YGL050W,YGL049C	5	7	4	16
chrVII	410071	420561	Complement	YGL048C,YGL047W,YGL045W,YGL044C,YGL043W,YGL042C,YGL041C-B,YGL041C,YGL041W-A,YGL040C	0	0	10	10
chrVII	423966	426810	SSDCluster	YGL039W,YGL038C	2	0	0	2
chrVII	427302	436838	Complement	YGL037C,YGL036W,YGL035C,YGL034C,YGL033W,YGL032C	0	0	6	6
chrVII	437471	437939	WGDCluster	YGL031C	0	1	0	1
chrVII	439095	450128	Complement	YGL030W,YGL029W,YGL028C,YGL027C,YGL026C,YGL025C,YGL024W	0	0	7	7
chrVII	450201	494178	SSDCluster	YGL023C,YGL022W,YGL021W,YGL020C,YGL019W,YGL018C,YGL017W,YGL016W,YGL015C,YGL014W,YGL014C-A,YGL013C,YGL012W,YGL011C,YGL010W,YGL009C,YGL008C,YGL007C-A,YGL007W,YGL006W-A,YGL006W,YGL005C,YGL004C,YGL003C	8	2	14	24
chrVII	494520	512827	WGDCluster	YGL002W,YGL001C,YGR001C,YGR002C,YGR003W,YGR004W,YGR005C,YGR006W,YGR007W,YGR008C,YGR009C,YGR010W,YGR011W	3	5	5	13
chrVII	513162	522080	SSDCluster	YGR012W,YGR013W,YGR014W,YGR015C	3	0	1	4
chrVII	522264	528508	Complement	YGR016W,YGR017W,YGR018C,YGR019W,YGR020C,YGR021W	0	0	6	6
chrVII	529260	534462	WGDCluster	YGR022C,YGR023W,YGR024C,YGR025W,YGR026W,YGR027C	0	3	3	6
chrVII	536060	546161	Complement	YGR027W-B,YGR027W-A,YGR028W,YGR029W,YGR030C	0	0	5	5
chrVII	546444	547304	SSDCluster	YGR031W,YGR031C-A	2	0	0	2
chrVII	548267	561354	WGDCluster	YGR032W,YGR033C,YGR034W,YGR035C,YGR035W-A,YGR036C,YGR037C,YGR038W	0	4	4	8
chrVII	562202	575203	Complement	YGR038C-B,YGR038C-A,YGR039W	0	0	3	3
chrVII	575401	576508	SSDCluster	YGR040W	1	0	0	1
chrVII	577490	598625	WGDCluster	YGR041W,YGR042W,YGR043C,YGR044C,YGR045C,YGR046W,YGR047C,YGR048W,YGR049W,YGR050C,YGR051C,YGR052W,YGR053C,YGR054W	0	3	11	14
chrVII	599420	621803	SSDCluster	YGR055W,YGR056W,YGR057C,YGR058W,YGR059W,YGR060W,YGR061C,YGR062C,YGR063C,YGR064W,YGR065C,YGR066C	5	1	6	12
chrVII	622405	627422	Complement	YGR067C,YGR068C,YGR068W-A,YGR069W	0	0	4	4
chrVII	627809	634067	WGDCluster	YGR070W,YGR071C	0	2	0	2
chrVII	634307	648146	Complement	YGR072W,YGR073C,YGR074W,YGR075C,YGR076C,YGR077C,YGR078C,YGR079W,YGR080W,YGR081C,YGR082W,YGR083C,YGR084C	0	0	13	13
chrVII	648386	648911	WGDCluster	YGR085C	0	1	0	1
chrVII	649601	656326	SSDCluster	YGR086C,YGR087C,YGR088W	2	0	1	3
chrVII	656963	667829	Complement	YGR089W,YGR090W,YGR091W	0	0	3	3
chrVII	668192	682139	WGDCluster	YGR092W,YGR093W,YGR094W,YGR095C,YGR096W,YGR097W	0	2	4	6
chrVII	682569	703120	Complement	YGR098C,YGR099W,YGR100W,YGR101W,YGR102C,YGR103W,YGR104C,YGR105W,YGR106C,YGR107W	0	0	10	10
chrVII	703639	706505	WGDCluster	YGR108W,YGR109C	0	2	0	2
chrVII	707613	730826	Complement	YGR109W-B,YGR109W-A,YGR110W,YGR111W,YGR112W,YGR113W,YGR114C,YGR115C,YGR116W,YGR117C,YGR118W,YGR119C,YGR120C	0	0	13	13
chrVII	731453	741667	WGDCluster	YGR121C,YGR121W-A,YGR122W,YGR122C-A,YGR123C,YGR124W	0	2	4	6
chrVII	742329	753849	Complement	YGR125W,YGR126W,YGR127W,YGR128C,YGR129W,YGR130C	0	0	6	6
chrVII	754730	787784	WGDCluster	YGR131W,YGR132C,YGR133W,YGR134W,YGR135W,YGR136W,YGR137W,YGR138C,YGR139W,YGR140W,YGR141W,YGR142W,YGR143W,YGR144W,YGR145W,YGR146C,YGR146C-A,YGR147C,YGR148C	2	8	9	19
chrVII	789035	797873	Complement	YGR149W,YGR150C,YGR151C,YGR152C,YGR153W,YGR154C	0	0	6	6
chrVII	798547	807689	SSDCluster	YGR155W,YGR156W,YGR157W,YGR158C,YGR159C,YGR160W	3	0	3	6
chrVII	808633	823020	Complement	YGR161C,YGR161W-C,YGR161W-A,YGR161W-B,YGR161C-D,YGR161C-C	0	0	6	6
chrVII	824063	836670	WGDCluster	YGR162W,YGR163W,YGR164W,YGR165W,YGR166W,YGR167W,YGR168C,YGR169C,YGR169C-A	1	2	6	9
chrVII	837146	865758	SSDCluster	YGR170W,YGR171C,YGR172C,YGR173W,YGR174C,YGR174W-A,YGR175C,YGR176W,YGR177C,YGR178C,YGR179C,YGR180C,YGR181W,YGR182C,YGR183C,YGR184C	6	1	9	16
chrVII	866340	871421	Complement	YGR185C,YGR186W,YGR187C	0	0	3	3
chrVII	872048	894145	WGDCluster	YGR188C,YGR189C,YGR190C,YGR191W,YGR192C,YGR193C,YGR194C,YGR195W,YGR196C,YGR197C	2	3	5	10
chrVII	894697	903202	Complement	YGR198W,YGR199W,YGR200C,YGR201C	0	0	4	4
chrVII	903478	919470	SSDCluster	YGR202C,YGR203W,YGR204W,YGR204C-A,YGR205W,YGR206W,YGR207C,YGR208W,YGR209C,YGR210C,YGR211W,YGR212W,YGR213C	4	1	8	13
chrVII	920579	936886	Complement	YGR214W,YGR215W,YGR216C,YGR217W,YGR218W,YGR219W,YGR220C	0	0	7	7
chrVII	937126	938995	WGDCluster	YGR221C	0	1	0	1
chrVII	939925	950902	Complement	YGR222W,YGR223C,YGR224W,YGR225W,YGR226C,YGR227W,YGR228W,YGR229C	0	0	8	8
chrVII	951896	952310	WGDCluster	YGR230W	0	1	0	1
chrVII	952550	958213	SSDCluster	YGR231C,YGR232W,YGR233C	2	0	1	3
chrVII	959907	965660	Complement	YGR234W,YGR235C,YGR236C,YGR237C	0	0	4	4
chrVII	966043	986744	WGDCluster	YGR238C,YGR239C,YGR240C,YGR240C-A,YGR241C,YGR242W,YGR243W,YGR244C,YGR245C,YGR246C,YGR247W,YGR248W	1	6	5	12
chrVII	988053	989424	SSDCluster	YGR249W	1	0	0	1
chrVII	991180	999145	Complement	YGR250C,YGR251W,YGR252W,YGR253C	0	0	4	4
chrVII	1000931	1006108	WGDCluster	YGR254W,YGR255C,YGR256W	0	2	1	3
chrVII	1006210	1007311	Complement	YGR257C	0	0	1	1
chrVII	1007676	1045487	SSDCluster	YGR258C,YGR259C,YGR260W,YGR261C,YGR262C,YGR263C,YGR264C,YGR265W,YGR266W,YGR267C,YGR268C,YGR269W,YGR270W,YGR270C-A,YGR271W,YGR271C-A,YGR273C,YGR274C,YGR275W,YGR276C	5	1	14	20
chrVII	1045650	1048471	Complement	YGR277C,YGR278W	0	0	2	2
chrVII	1048804	1060047	WGDCluster	YGR279C,YGR280C,YGR281W,YGR282C,YGR283C	0	2	3	5
chrVII	1060664	1076511	Complement	YGR284C,YGR285C,YGR286C,YGR287C,YGR288W,YGR289C,YGR290W,YGR291C	0	0	8	8
chrVII	1076605	1090235	SSDCluster	YGR292W,YGR293C,YGR294W,YGR295C,YGR296W,YGR296C-A,YGR296C-B	6	0	1	7
chrVIII	972	7545	Complement	YHL050W-A,YHL049C,YHL048C-A,YHL048W	0	0	4	4
chrVIII	9574	27879	SSDCluster	YHL047C,YHL046W-A,YHL046C,YHL045W,YHL044W,YHL043W,YHL042W,YHL041W,YHL040C,YHL039W,YHL038C,YHL037C,YHL036W	5	0	8	13
chrVIII	27975	36023	WGDCluster	YHL035C,YHL034W-A,YHL034C,YHL033C	0	4	0	4
chrVIII	36376	70067	Complement	YHL032C,YHL031C,YHL030W-A,YHL030W,YHL029C,YHL028W,YHL027W,YHL026C,YHL025W,YHL024W,YHL023C,YHL022C,YHL021C,YHL020C,YHL019W-A,YHL019C,YHL018W	0	0	17	17
chrVIII	70272	80413	WGDCluster	YHL017W,YHL016C,YHL015W-A,YHL015W,YHL014C,YHL013C,YHL012W	1	2	4	7
chrVIII	80649	100399	Complement	YHL011C,YHL010C,YHL009C,YHL009W-B,YHL009W-A,YHL008C,YHL007C,YHL006W-A,YHL006C,YHL005C,YHL004W	0	0	11	11
chrVIII	100643	138448	WGDCluster	YHL003C,YHL002C-A,YHL002W,YHL001W,YHR001W,YHR001W-A,YHR002W,YHR003C,YHR004C,YHR005C,YHR005C-A,YHR006W,YHR007C,YHR007C-A,YHR008C,YHR009C,YHR010W,YHR011W,YHR012W,YHR013C,YHR014W,YHR015W,YHR016C	6	7	10	23
chrVIII	138686	141395	Complement	YHR017W,YHR018C	0	0	2	2
chrVIII	141886	143551	SSDCluster	YHR019C	1	0	0	1
chrVIII	143988	157445	Complement	YHR020W,YHR021C,YHR021W-A,YHR022C,YHR022C-A,YHR023W	0	0	6	6
chrVIII	157736	214720	SSDCluster	YHR024C,YHR025W,YHR026W,YHR027C,YHR028C,YHR028W-A,YHR029C,YHR030C,YHR031C,YHR032W,YHR032W-A,YHR032C-A,YHR033W,YHR034C,YHR035W,YHR036W,YHR037W,YHR038W,YHR039C,YHR039C-A,YHR040W,YHR041C,YHR042W,YHR043C,YHR044C,YHR045W,YHR046C,YHR047C,YHR048W,YHR049W,YHR049C-A,YHR050W,YHR050W-A,YHR051W,YHR052W,RUF5-1,YHR052W-A,YHR053C,YHR054C,RUF5-2,YHR054W-A,YHR055C	20	3	19	42
chrVIII	215184	230698	WGDCluster	YHR056C,YHR056W-A,YHR057C,YHR058C,YHR059W,YHR060W,YHR061C,YHR062C,YHR063C,YHR063W-A,YHR064C,YHR065C,YHR066W	2	5	6	13
chrVIII	230971	262555	Complement	YHR067W,YHR068W,YHR069C,YHR069C-A,YHR070W,YHR070C-A,YHR071W,YHR071C-A,YHR072W,YHR072W-A,YHR073W,YHR073W-A,YHR073C-B,YHR074W,YHR075C,YHR076W,YHR077C,YHR078W,YHR079C,YHR079C-A	0	0	20	20
chrVIII	262802	266840	WGDCluster	YHR080C	0	1	0	1
chrVIII	267539	277770	Complement	YHR081W,YHR082C,YHR083W,YHR084W,YHR085W	0	0	5	5
chrVIII	278154	284627	SSDCluster	YHR086W,YHR086W-A,YHR087W,YHR088W,YHR089C,YHR090C	3	0	3	6
chrVIII	284840	296450	WGDCluster	YHR091C,YHR092C,YHR093W,YHR094C,YHR095W,YHR096C	0	3	3	6
chrVIII	297387	315971	Complement	YHR097C,YHR098C,YHR099W,YHR100C,YHR101C	0	0	5	5
chrVIII	316574	319817	SSDCluster	YHR102W	1	0	0	1
chrVIII	320416	330063	WGDCluster	YHR103W,YHR104W,YHR105W,YHR106W,YHR107C,YHR108W	1	3	2	6
chrVIII	330312	335666	Complement	YHR109W,YHR110W,YHR111W,YHR112C	0	0	4	4
chrVIII	336339	337812	SSDCluster	YHR113W	1	0	0	1
chrVIII	338085	339987	Complement	YHR114W	0	0	1	1
chrVIII	340111	344271	WGDCluster	YHR115C,YHR116W,YHR117W	0	2	1	3
chrVIII	344323	345631	Complement	YHR118C	0	0	1	1
chrVIII	346045	349288	SSDCluster	YHR119W	1	0	0	1
chrVIII	349576	361647	Complement	YHR120W,YHR121W,YHR122W,YHR123W,YHR124W,YHR125W,YHR126C,YHR127W	0	0	8	8
chrVIII	362117	364156	SSDCluster	YHR128W,YHR129C	2	0	0	2
chrVIII	364967	365303	Complement	YHR130C	0	0	1	1
chrVIII	365342	424475	WGDCluster	YHR131C,YHR131W-A,YHR132C,YHR132W-A,YHR133C,YHR134W,YHR135C,YHR136C,YHR137W,YHR137C-A,YHR138C,YHR139C,YHR139C-A,YHR140W,YHR141C,YHR142W,YHR143W,YHR143W-A,YHR144C,YHR145C,YHR146W,YHR147C,YHR148W,YHR149C,YHR150W,YHR151C,YHR152W,YHR153C,YHR154W,YHR155W,YHR156C,YHR157W,YHR158C,YHR159W,YHR160C,YHR161C,YHR162W,YHR163W	3	16	19	38
chrVIII	424611	436960	Complement	YHR164C,YHR165C,YHR165W-A	0	0	3	3
chrVIII	437171	443477	SSDCluster	YHR166C,YHR167W,YHR168W,YHR169W	2	0	2	4
chrVIII	443828	451153	Complement	YHR170W,YHR171W,YHR172W,YHR173C	0	0	4	4
chrVIII	451326	457952	WGDCluster	YHR174W,YHR175W,YHR175W-A,YHR176W,YHR177W	0	2	3	5
chrVIII	459298	463704	SSDCluster	YHR178W,YHR179W	2	0	0	2
chrVIII	465177	470576	Complement	YHR180W,YHR180W-A,YHR180C-B,YHR181W,YHR182W	0	0	5	5
chrVIII	470938	472429	WGDCluster	YHR182C-A,YHR183W	0	2	0	2
chrVIII	472743	488236	Complement	YHR184W,YHR185C,YHR186C,YHR187W,YHR188C,YHR189W,YHR190W,YHR191C,YHR192W,YHR193C	0	0	10	10
chrVIII	488652	521737	SSDCluster	YHR193C-A,YHR194W,YHR195W,YHR196W,YHR197W,YHR198C,YHR199C,YHR199C-A,YHR200W,YHR201C,YHR202W,YHR203C,YHR204W,YHR205W,YHR206W,YHR207C,YHR208W,YHR209W,YHR210C	8	2	9	19
chrVIII	525391	541099	Complement	YHR211W,YHR212C,YHR212W-A,YHR213W,YHR213W-A,YHR213W-B	0	0	6	6
chrVIII	541650	555967	SSDCluster	YHR214W,YHR214W-A,YHR214C-B,YHR214C-C,YHR214C-D,YHR214C-E,YHR215W,YHR216W	3	0	5	8
chrVIII	556580	561681	Complement	YHR217C,YHR218W,YHR218W-A,YHR219W,YHR219C-A	0	0	5	5
chrIX	482	45952	SSDCluster	YIL177C,YIL177W-A,YIL176C,YIL175W,YIL174W,YIL173W,YIL172C,YIL171W-A,YIL171W,YIL170W,YIL169C,YIL168W,YIL167W,YIL166C,YIL165C,YIL164C,YIL163C,YIL162W,YIL161W,YIL160C,YIL159W	10	0	11	21
chrIX	46200	68067	WGDCluster	YIL158W,YIL157C,YIL156W-A,YIL156W-B,YIL156W,YIL155C,YIL154C,YIL153W,YIL152W,YIL151C,YIL150C,YIL149C	1	4	7	12
chrIX	68707	88716	Complement	YIL148W,YIL147C,YIL146C,YIL145C,YIL144W,YIL143C,YIL142C-A,YIL142W,YIL141W,YIL140W,YIL139C	0	0	11	11
chrIX	89229	102235	WGDCluster	YIL138C,YIL137C,YIL136W,YIL135C,YIL134C-A,YIL134W,YIL133C,YIL132C,YIL131C	0	3	6	9
chrIX	102781	105676	SSDCluster	YIL130W	1	0	0	1
chrIX	106106	117644	Complement	YIL129C,YIL128W,YIL127C	0	0	3	3
chrIX	117991	148706	SSDCluster	YIL126W,YIL125W,YIL124W,YIL123W,YIL122W,YIL121W,YIL120W,YIL119C,YIL118W,YIL117C,YIL116W,YIL115W-A,YIL115C	6	3	4	13
chrIX	149139	167801	WGDCluster	YIL114C,YIL113W,YIL112W,YIL111W,YIL110W,YIL109C,YIL108W,YIL107C,YIL106W,YIL105C,YIL105W-A	1	5	5	11
chrIX	169978	171502	Complement	YIL104C	0	0	1	1
chrIX	171747	174884	SSDCluster	YIL103W,YIL102C-A,YIL102C	2	0	1	3
chrIX	175303	183124	Complement	YIL101C,YIL100C-A,YIL100W,YIL099W,YIL098C,YIL097W,YIL096C	0	0	7	7
chrIX	183933	186366	WGDCluster	YIL095W	0	1	0	1
chrIX	186513	195067	Complement	YIL094C,YIL093C,YIL092W,YIL091C,YIL090W	0	0	5	5
chrIX	195595	196213	SSDCluster	YIL089W	1	0	0	1
chrIX	197927	200458	Complement	YIL088C,YIL087C,YIL086C	0	0	3	3
chrIX	200486	222487	WGDCluster	YIL085C,YIL084C,YIL083C,YIL082W,YIL080W,YIL082W-A,YIL079C,YIL078W,YIL077C,YIL076W,YIL075C,YIL074C	2	3	7	12
chrIX	222933	237806	Complement	YIL073C,YIL072W,YIL071W-A,YIL071C,YIL070C,YIL069C,YIL068W-A,YIL068C,YIL067C,YIL066W-A	0	0	10	10
chrIX	238095	259769	WGDCluster	YIL066C,YIL065C,YIL064W,YIL063C,YIL062C,YIL061C,YIL060W,YIL059C,YIL058W,YIL057C,YIL056W,YIL055C,YIL054W,YIL053W,YIL052C,YIL051C,YIL050W	0	6	11	17
chrIX	260156	268472	Complement	YIL049W,YIL048W,YIL047C-A,YIL047C,YIL046W-A	0	0	5	5
chrIX	268649	301255	SSDCluster	YIL046W,YIL045W,YIL044C,YIL043C,YIL042C,YIL041W,YIL040W,YIL039W,YIL038C,YIL037C,YIL036W,YIL035C,YIL034C,YIL033C,YIL032C,YIL031W,YIL030W-A,YIL030C,YIL029W-A,YIL029C	9	2	9	20
chrIX	302097	312458	Complement	YIL028W,YIL027C,YIL026C,YIL025C,YIL024C,YIL023C,YIL022W	0	0	7	7
chrIX	312902	314049	SSDCluster	YIL021W,YIL021C-A,YIL020C-A	3	0	0	3
chrIX	314032	324103	Complement	YIL020C,YIL019W,YIL018W,YIL017C,YIL016W,YIL015W	0	0	6	6
chrIX	325209	350000	SSDCluster	YIL014C-A,YIL014W,YIL013C,YIL012W,YIL011W,YIL010W,YIL009C-A,YIL009W,YIL008W,YIL007C,YIL006W,YIL005W,YIL004C,YIL003W	5	2	7	14
chrIX	350297	362921	Complement	YIL002W-A,YIL002C,YIL001W,YIR001C,YIR002C,YIR003W	0	0	6	6
chrIX	363217	369905	SSDCluster	YIR004W,YIR005W,YIR006C	2	0	1	3
chrIX	370700	379778	Complement	YIR007W,YIR008C,YIR009W,YIR010W,YIR011C,YIR012W	0	0	6	6
chrIX	380015	380381	SSDCluster	YIR013C	1	0	0	1
chrIX	381082	382379	Complement	YIR014W,YIR015W	0	0	2	2
chrIX	382624	385343	WGDCluster	YIR016W,YIR017C,YIR017W-A,YIR018W	0	2	2	4
chrIX	385560	385698	Complement	YIR018C-A	0	0	1	1
chrIX	389568	393672	SSDCluster	YIR019C	1	0	0	1
chrIX	393880	396936	Complement	ICR1,YIR020C,YIR020W-A,PWR1	0	0	4	4
chrIX	397211	398382	WGDCluster	YIR020C-B,YIR021W	0	2	0	2
chrIX	398510	407639	Complement	YIR021W-A,YIR022W,YIR023W,YIR023C-A,YIR024C,YIR025W,YIR026C,YIR027C	0	0	8	8
chrIX	408464	423033	SSDCluster	YIR028W,YIR029W,YIR030C,YIR030W-A,YIR031C,YIR032C,YIR033W,YIR034C,YIR035C,YIR036C,YIR036W-A	6	1	4	11
chrIX	423124	423616	WGDCluster	YIR037W	0	1	0	1
chrIX	423805	438176	Complement	YIR038C,YIR039C,YIR040C,YIR041W,YIR042C,YIR043C,YIR044C	0	0	7	7
chrX	465	21200	SSDCluster	YJL225C,YJL225W-A,YJL223C,YJL222W-B,YJL222W-A,YJL222W,YJL221C,YJL220W,YJL219W	7	0	2	9
chrX	21972	33158	Complement	YJL218W,YJL217W,YJL216C,YJL215C,YJL214W,YJL213W	0	0	6	6
chrX	33849	36249	SSDCluster	YJL212C	1	0	0	1
chrX	36756	47433	Complement	YJL211C,YJL210W,YJL209W,YJL208C,YJL207C	0	0	5	5
chrX	47658	58813	SSDCluster	YJL206C,YJL205C,YJL204C,YJL203W,YJL202C,YJL201W,YJL200C	2	0	5	7
chrX	59854	60181	Complement	YJL199C	0	0	1	1
chrX	60842	74610	WGDCluster	YJL198W,YJL197W,YJL197C-A,YJL196C,YJL195C,YJL194W,YJL193W,YJL192C,YJL191W	1	3	5	9
chrX	74908	104422	SSDCluster	YJL190C,YJL189W,YJL188C,YJL187C,YJL186W,YJL185C,YJL184W,YJL183W,YJL182C,YJL181W,YJL180C,YJL179W,YJL178C,YJL177W,YJL176C,YJL175W,YJL174W,YJL173C,YJL172W,YJL171C,YJL170C,YJL169W,YJL168C	9	2	12	23
chrX	105007	106712	Complement	YJL167W,YJL166W	0	0	2	2
chrX	106887	121686	WGDCluster	YJL165C,YJL164C,YJL163C,YJL162C,YJL161W,YJL160C,YJL159W	0	4	3	7
chrX	122260	128948	Complement	YJL158C,YJL157C,YJL156W-A,YJL156C	0	0	4	4
chrX	129280	150386	SSDCluster	YJL155C,YJL154C,YJL153C,YJL152W,YJL151C,YJL150W,YJL149W,YJL148W,YJL147C,YJL146W,YJL145W,YJL144W,YJL143W,YJL142C,YJL141C	5	0	10	15
chrX	150956	151622	Complement	YJL140W	0	0	1	1
chrX	151708	161559	WGDCluster	YJL139C,YJL138C,YJL137C,YJL136W-A,YJL136C,YJL135W,YJL134W,YJL133C-A,YJL133W	0	6	3	9
chrX	161909	165344	Complement	YJL132W,YJL131C	0	0	2	2
chrX	165718	172363	SSDCluster	YJL130C	1	0	0	1
chrX	173594	177302	WGDCluster	YJL129C	0	1	0	1
chrX	178092	184217	Complement	YJL128C,YJL127W-A,YJL127C-B,YJL127C	0	0	4	4
chrX	184497	185421	SSDCluster	YJL126W	1	0	0	1
chrX	185524	193464	Complement	YJL125C,YJL124C,YJL123C,YJL122W,YJL121C,YJL120W,YJL119C,YJL118W,YJL117W	0	0	9	9
chrX	193857	194871	WGDCluster	YJL116C	0	1	0	1
chrX	196283	203324	Complement	YJL115W,YJL114W,YJL113W	0	0	3	3
chrX	205299	211572	WGDCluster	YJL112W,YJL111W,YJL110C	1	2	0	3
chrX	211994	223322	Complement	YJL109C,YJL108C,YJL107C,YJL106W	0	0	4	4
chrX	225049	226732	WGDCluster	YJL105W	0	1	0	1
chrX	227321	227771	Complement	YJL104W	0	0	1	1
chrX	229019	233755	SSDCluster	YJL103C,YJL102W	2	0	0	2
chrX	234314	239081	Complement	YJL101C,YJL100W	0	0	2	2
chrX	239408	245253	WGDCluster	YJL099W,YJL098W	0	2	0	2
chrX	245585	246970	Complement	YJL097W,YJL096W	0	0	2	2
chrX	247248	268409	SSDCluster	YJL095W,YJL094C,YJL093C,YJL092W,YJL091C,YJL090C,YJL089W	3	0	4	7
chrX	268792	274692	Complement	YJL088W,YJL087C,YJL086C,YJL085W	0	0	4	4
chrX	274855	315564	WGDCluster	YJL084C,YJL083W,YJL082W,YJL081C,YJL080C,YJL079C,YJL078C,YJL077W-B,YJL077C,YJL077W-A,YJL076W,YJL075C,YJL074C,YJL073W,YJL072C,YJL071W,YJL070C,YJL069C,YJL068C,YJL067W,YJL066C,YJL065C,YJL064W	1	9	13	23
chrX	315752	316974	Complement	YJL063C,YJL062W-A	0	0	2	2
chrX	317277	319770	SSDCluster	YJL062W	1	0	0	1
chrX	320009	326184	Complement	YJL061W,YJL060W,YJL059W	0	0	3	3
chrX	326235	327867	WGDCluster	YJL058C	0	1	0	1
chrX	328111	330115	Complement	YJL057C	0	0	1	1
chrX	330424	345737	SSDCluster	YJL056C,YJL055W,YJL054W,YJL053W,YJL052C-A,YJL052W,YJL051W,YJL050W	2	0	6	8
chrX	345966	347319	Complement	YJL049W	0	0	1	1
chrX	347440	357922	WGDCluster	YJL048C,YJL047C-A,YJL047C,YJL046W,YJL045W	0	3	2	5
chrX	358293	359670	Complement	YJL044C	0	0	1	1
chrX	360123	360897	SSDCluster	YJL043W	1	0	0	1
chrX	361242	373793	Complement	YJL042W,YJL041W,YJL039C	0	0	3	3
chrX	375108	387432	SSDCluster	YJL038C,YJL037W,YJL036W,YJL035C,YJL034W,YJL033W,YJL032W,YJL031C	5	0	3	8
chrX	387650	392243	Complement	YJL030W,YJL029C,YJL028W,YJL027C	0	0	4	4
chrX	392397	393281	WGDCluster	YJL026W,YJL026C-A	0	2	0	2
chrX	393960	407510	Complement	YJL025W,YJL024C,YJL023C,YJL022W,YJL020C,YJL020W-A,YJL019W,YJL016W,YJL015C	0	0	9	9
chrX	407550	409155	SSDCluster	YJL014W	1	0	0	1
chrX	409485	411033	WGDCluster	YJL013C	0	1	0	1
chrX	411226	444853	Complement	YJL012C,YJL011C,YJL010C,YJL009W,YJL008C,YJL007C,YJL006C,YJL005W,YJL004C,YJL003W,YJL002C,YJL001W,YJR001W,YJR002W,YJR003C,YJR004C	0	0	16	16
chrX	445914	448017	SSDCluster	YJR005W	1	0	0	1
chrX	448468	464245	WGDCluster	YJR005C-A,YJR006W,YJR007W,YJR008W,YJR009C,YJR010W,YJR010C-A,YJR011C,YJR012C,YJR013W,YJR014W,YJR015W	0	3	9	12
chrX	464442	479658	Complement	YJR016C,YJR017C,YJR018W,YJR019C,YJR020W,YJR021C,YJR022W,YJR023C,YJR024C,YJR025C,YJR026W,YJR027W,YJR029W,YJR028W	0	0	14	14
chrX	483950	490804	WGDCluster	YJR030C,YJR031C	0	2	0	2
chrX	491072	492254	SSDCluster	YJR032W	1	0	0	1
chrX	492369	503477	Complement	YJR033C,YJR034W,YJR035W,YJR036C,YJR037W	0	0	5	5
chrX	503701	507293	WGDCluster	YJR038C,YJR039W	0	2	0	2
chrX	507737	519177	Complement	YJR040W,YJR041C,YJR042W,YJR043C,YJR044C	0	0	5	5
chrX	519629	566820	WGDCluster	YJR045C,YJR046W,YJR047C,YJR048W,YJR049C,YJR050W,YJR051W,YJR052W,YJR053W,YJR054W,YJR055W,YJR056C,YJR057W,YJR058C,YJR059W,YJR060W,YJR061W,YJR062C,YJR063W,YJR064W,YJR065C,YJR066W	2	9	11	22
chrX	567010	573743	Complement	YJR067C,YJR068W,YJR069C,YJR070C,YJR071W,YJR072C,YJR073C,YJR074W	0	0	8	8
chrX	573972	578182	SSDCluster	YJR075W,YJR076C,YJR077C	3	0	0	3
chrX	578851	590574	Complement	YJR078W,YJR079W,YJR080C,YJR082C,YJR083C,YJR084W,YJR085C,YJR086W,YJR087W,YJR088C,YJR089W	0	0	11	11
chrX	590863	594319	SSDCluster	YJR090C	1	0	0	1
chrX	595052	598328	WGDCluster	YJR091C	0	1	0	1
chrX	598726	608850	Complement	YJR092W,YJR093C,YJR094C,YJR094W-A	0	0	4	4
chrX	609764	649132	SSDCluster	YJR095W,YJR096W,YJR097W,YJR098C,YJR099W,YJR100C,YJR101W,YJR102C,YJR103W,YJR104C,YJR105W,YJR106W,YJR107W,YJR108W,YJR109C,YJR110W,YJR111C,YJR112W,YJR112W-A,YJR113C,YJR114W,YJR115W,YJR116W,YJR117W,YJR118C,YJR119C,YJR120W,YJR121W	7	2	19	28
chrX	649765	658679	Complement	YJR122W,YJR123W,YJR124C,YJR125C,YJR126C	0	0	5	5
chrX	658906	667127	WGDCluster	YJR127C,YJR128W,YJR129C,YJR130C	0	3	1	4
chrX	667633	673610	SSDCluster	YJR131W,YJR132W,YJR133W	3	0	0	3
chrX	673718	705262	Complement	YJR134C,YJR135C,YJR135W-A,YJR136C,YJR137C,YJR138W,YJR139C,YJR140C,YJR140W-A,YJR141W,YJR142W,YJR143C,YJR144W,YJR145C,YJR146W,YJR147W	0	0	16	16
chrX	705733	706864	WGDCluster	YJR148W	0	1	0	1
chrX	707149	717620	Complement	YJR149W,YJR150C,YJR151C,YJR151W-A	0	0	4	4
chrX	719655	721287	SSDCluster	YJR152W	1	0	0	1
chrX	722804	730867	Complement	YJR153W,YJR154W,YJR155W,YJR156C,YJR157W	0	0	5	5
chrX	732429	743989	SSDCluster	YJR158W,YJR159W,YJR160C,YJR161C	4	0	0	4
chrX	744900	745251	Complement	YJR162C	0	0	1	1
chrXI	451	5621	Complement	YKL225W,YKL224C,YKL223W,YKL222C	0	0	4	4
chrXI	6107	18339	SSDCluster	YKL221W,YKL220C,YKL219W,YKL218C	2	1	1	4
chrXI	22233	36415	Complement	YKL217W,YKL216W,YKL215C,YKL214C,YKL213C,YKL212W	0	0	6	6
chrXI	36699	42238	SSDCluster	YKL211C,YKL210W	2	0	0	2
chrXI	42423	55603	Complement	YKL209C,YKL208W,YKL207W,YKL206C,YKL205W,YKL204W	0	0	6	6
chrXI	55935	70223	WGDCluster	YKL203C,YKL202W,YKL201C,YKL198C	0	4	0	4
chrXI	70738	73870	Complement	YKL197C	0	0	1	1
chrXI	74936	88791	SSDCluster	YKL196C,YKL195W,YKL194C,YKL193C,YKL192C,YKL191W,YKL190W,YKL189W,YKL188C	4	0	5	9
chrXI	89288	91541	WGDCluster	YKL187C	0	1	0	1
chrXI	92748	108604	Complement	YKL186C,YKL185W,YKL184W,YKL183C-A,YKL183W,YKL182W,YKL181W	0	0	7	7
chrXI	109273	110134	WGDCluster	YKL180W	0	1	0	1
chrXI	110468	131073	Complement	YKL179C,YKL178C,YKL177W,YKL176C,YKL175W,YKL174C,YKL173W,YKL172W,YKL171W,YKL170W,YKL169C	0	0	11	11
chrXI	131292	171134	WGDCluster	YKL168C,YKL167C,YKL166C,YKL165C-A,YKL165C,YKL164C,YKL163W,YKL162C-A,YKL162C,YKL161C,YKL160W,YKL159C,YKL157W,YKL156W,YKL156C-A,YKL155C,YKL154W,YKL153W,YKL152C,YKL151C,YKL150W,YKL149C,YKL148C	0	8	15	23
chrXI	171555	191441	SSDCluster	YKL147C,YKL146W,YKL145W,YKL145W-A,YKL144C,YKL143W,YKL142W,YKL141W,YKL140W,YKL139W,YKL138C-A,YKL138C,YKL137W,YKL136W,YKL135C,YKL134C	7	1	8	16
chrXI	191677	207393	WGDCluster	YKL133C,YKL132C,YKL131W,YKL130C,YKL129C,YKL128C,YKL127W,YKL126W	0	6	2	8
chrXI	207890	209774	Complement	YKL125W	0	0	1	1
chrXI	210236	225519	SSDCluster	YKL124W,YKL123W,YKL122C,YKL121W,YKL120W,YKL119C,YKL118W,YKL117W,YKL116C,YKL115C,YKL114C,YKL113C	4	1	7	12
chrXI	226213	236910	Complement	YKL112W,YKL111C,YKL110C,YKL109W,YKL108W,YKL107W,YKL106C-A	0	0	7	7
chrXI	237179	247326	SSDCluster	YKL106W,YKL105C,YKL104C,YKL103C	3	1	0	4
chrXI	247705	263934	Complement	YKL102C,YKL101W,YKL100C,YKL100W-A,YKL099C,YKL098W,YKL097C,YKL096C-B,YKL096W-A,YKL096W,YKL095W,YKL094W	0	0	12	12
chrXI	264432	270294	WGDCluster	YKL093W,YKL092C,YKL091C	0	2	1	3
chrXI	271521	276642	Complement	YKL090W,YKL089W,YKL088W	0	0	3	3
chrXI	276832	279771	SSDCluster	YKL087C,YKL086W,YKL085W	2	0	1	3
chrXI	280152	298719	Complement	YKL084W,YKL083W,YKL082C,YKL081W,YKL080W,YKL079W,YKL078W,YKL077W,YKL076C,YKL075C,YKL074C,YKL073W	0	0	12	12
chrXI	299225	324764	WGDCluster	YKL072W,YKL071W,YKL070W,YKL069W,YKL068W-A,YKL068W,YKL067W,YKL066W,YKL065W-A,YKL065C,YKL064W,YKL063C,YKL062W	0	4	9	13
chrXI	325414	342017	Complement	YKL061W,YKL060C,YKL059C,YKL058W,YKL057C,YKL056C,YKL055C,YKL054C,YKL053C-A,YKL053W,YKL052C,YKL051W	0	0	12	12
chrXI	342495	345264	WGDCluster	YKL050C	0	1	0	1
chrXI	345718	350657	Complement	YKL049C,YKL048C,YKL047W	0	0	3	3
chrXI	350918	368760	SSDCluster	YKL046C,YKL045W,YKL044W,YKL043W,YKL042W,YKL041W,YKL040C,YKL039W,YKL038W	3	2	4	9
chrXI	369007	369364	Complement	YKL037W	0	0	1	1
chrXI	369170	389526	WGDCluster	YKL036C,YKL035W,YKL034W,YKL033W-A,YKL033W,YKL032C,YKL031W,YKL030W,YKL029C,YKL028W,YKL027W,YKL026C	0	5	7	12
chrXI	389882	394197	Complement	YKL025C,YKL024C,YKL023C-A,YKL023W	0	0	4	4
chrXI	394368	403161	SSDCluster	YKL022C,YKL021C,YKL020C,YKL019W	2	1	1	4
chrXI	403222	419704	Complement	YKL018C-A,YKL018W,YKL017C,YKL016C,YKL015W,YKL014C,YKL013C,YKL012W	0	0	8	8
chrXI	419797	428194	WGDCluster	YKL011C,YKL010C,YKL009W,YKL008C	1	2	1	4
chrXI	428944	434520	Complement	YKL007W,YKL006C-A,YKL006W,YKL005C	0	0	4	4
chrXI	435222	442365	SSDCluster	YKL004W,YKL003C,YKL002W,YKL001C,YKR001C	2	0	3	5
chrXI	442874	444581	Complement	YKR002W	0	0	1	1
chrXI	445023	446370	WGDCluster	YKR003W	0	1	0	1
chrXI	446441	453721	Complement	YKR004C,YKR005C,YKR006C,YKR007W,YKR008W	0	0	5	5
chrXI	453994	456697	SSDCluster	YKR009C	1	0	0	1
chrXI	458566	534923	WGDCluster	YKR010C,YKR011C,YKR012C,YKR013W,YKR014C,YKR015C,YKR016W,YKR017C,YKR018C,YKR019C,YKR020W,YKR021W,YKR022C,YKR023W,YKR024C,YKR025W,YKR026C,YKR027W,YKR028W,YKR029C,YKR030W,YKR031C,YKR032W,YKR033C,YKR034W,YKR035C,YKR035W-A,YKR036C,YKR037C,YKR038C,YKR039W,YKR040C,YKR041W,YKR042W,YKR043C,YKR044W,YKR045C,YKR046C,YKR047W,YKR048C,YKR049C,YKR050W,YKR051W,YKR052C,YKR053C	4	16	25	45
chrXI	535288	547567	SSDCluster	YKR054C	1	0	0	1
chrXI	547857	551884	Complement	YKR055W,YKR056W,YKR057W	0	0	3	3
chrXI	552411	558596	WGDCluster	YKR058W,YKR059W,YKR060W,YKR061W	0	3	1	4
chrXI	559307	566840	Complement	YKR062W,YKR063C,YKR064W,YKR065C,YKR066C	0	0	5	5
chrXI	567559	569791	SSDCluster	YKR067W	1	0	0	1
chrXI	569969	575622	Complement	YKR068C,YKR069W,YKR070W,YKR071C	0	0	4	4
chrXI	576076	586351	WGDCluster	YKR072C,YKR073C,YKR074W,YKR075C,YKR075W-A,YKR076W,YKR077W,YKR078W	1	5	2	8
chrXI	586430	596464	Complement	YKR079C,YKR080W,YKR081C,YKR082W,YKR083C	0	0	5	5
chrXI	596696	639606	WGDCluster	YKR084C,YKR085C,YKR086W,YKR087C,YKR088C,YKR089C,YKR090W,YKR091W,YKR092C,YKR093W,YKR094C,YKR095W,YKR095W-A,YKR096W,YKR097W,YKR098C,YKR099W,YKR100C	1	7	10	18
chrXI	640177	657394	Complement	YKR101W,YKR102W,YKR103W,YKR104W	0	0	4	4
chrXI	658353	662927	WGDCluster	YKR105C,YKR106W	0	2	0	2
chrXII	84	5775	Complement	YLL067C,YLL067W-A,YLL066W-B	0	0	3	3
chrXII	6119	13445	SSDCluster	YLL066C,YLL066W-A,YLL065W,YLL064C	3	0	1	4
chrXII	14647	16072	Complement	YLL063C	0	0	1	1
chrXII	16638	19707	WGDCluster	YLL062C,YLL061W	0	2	0	2
chrXII	21137	31704	Complement	YLL060C,YLL059C,YLL058W,YLL057C,YLL056C,YLL055W	0	0	6	6
chrXII	32893	36360	SSDCluster	YLL054C,YLL053C,YLL052C	3	0	0	3
chrXII	37331	48661	WGDCluster	YLL051C,YLL050C,YLL049W,YLL048C,YLL047W,YLL046C,YLL045C,YLL044W	0	6	2	8
chrXII	49936	51946	SSDCluster	YLL043W	1	0	0	1
chrXII	52085	76746	Complement	YLL042C,YLL041C,YLL040C,YLL039C,YLL038C,YLL037W,YLL036C,YLL035W,YLL034C,YLL033W,YLL032C	0	0	11	11
chrXII	77150	121110	SSDCluster	YLL031C,YLL030C,YLL029W,YLL028W,YLL027W,YLL026W,YLL025W,YLL024C,YLL023C,YLL022C,YLL021W,YLL020C,YLL019C,YLL019W-A,YLL018C-A,YLL018C,YLL017W,YLL016W,YLL015W	10	1	8	19
chrXII	121320	124713	Complement	YLL014W,YLL013C	0	0	2	2
chrXII	125532	130612	WGDCluster	YLL012W,YLL011W,YLL010C	0	2	1	3
chrXII	131203	147600	Complement	YLL009C,YLL008W,YLL007C,YLL006W-A,YLL006W,YLL005C,YLL004W,YLL003W,YLL002W	0	0	9	9
chrXII	147888	198086	SSDCluster	YLL001W,YLR001C,YLR002C,YLR003C,YLR004C,YLR005W,YLR006C,YLR007W,YLR008C,YLR009W,YLR010C,YLR011W,YLR012C,YLR013W,YLR014C,YLR015W,YLR016C,YLR017W,YLR018C,YLR019W,YLR020C,YLR021W,YLR022C,YLR023C,YLR024C,YLR025W,YLR026C,YLR027C	8	2	18	28
chrXII	199540	204786	WGDCluster	YLR028C,YLR029C,YLR030W,YLR031W	0	3	1	4
chrXII	204991	218908	Complement	YLR032W,YLR033W,YLR034C,YLR035C,YLR035C-A	0	0	5	5
chrXII	221521	241408	SSDCluster	YLR036C,YLR037C,YLR038C,YLR039C,YLR040C,YLR041W,YLR042C,YLR043C,YLR044C,YLR045C,YLR046C,YLR047C	4	1	7	12
chrXII	242232	257856	Complement	YLR048W,YLR049C,YLR050C,YLR051C,YLR052W,YLR053C,YLR054C,YLR055C,YLR056W,YLR057W	0	0	10	10
chrXII	257992	273916	SSDCluster	YLR058C,YLR059C,YLR060W,YLR061W,YLR062C,YLR063W,YLR064W,YLR065C,YLR066W,YLR067C,YLR068W,YLR069C	3	0	9	12
chrXII	274141	278627	Complement	YLR070C,YLR071C	0	0	2	2
chrXII	278862	296095	WGDCluster	YLR072W,YLR073C,YLR074C,YLR075W,YLR076C,YLR077W,YLR078C,YLR079W,YLR080W,YLR081W,YLR082C,YLR083C	0	3	9	12
chrXII	296589	301990	Complement	YLR084C,YLR085C	0	0	2	2
chrXII	302243	306500	SSDCluster	YLR086W	1	0	0	1
chrXII	306855	317952	Complement	YLR087C,YLR088W	0	0	2	2
chrXII	318237	320016	WGDCluster	YLR089C	0	1	0	1
chrXII	320701	323179	Complement	YLR090W,YLR091W	0	0	2	2
chrXII	323544	326226	SSDCluster	YLR092W	1	0	0	1
chrXII	326513	332116	Complement	YLR093C,YLR094C,YLR095C	0	0	3	3
chrXII	332590	340929	WGDCluster	YLR096W,YLR097C,YLR098C,YLR099C	1	2	1	4
chrXII	341325	348181	Complement	YLR099W-A,YLR100W,YLR101C,YLR102C,YLR103C,YLR104W,YLR105C	0	0	7	7
chrXII	349006	365331	SSDCluster	YLR106C,YLR107W	2	0	0	2
chrXII	366667	368125	WGDCluster	YLR108C	0	1	0	1
chrXII	368781	386176	Complement	YLR109W,YLR110C,YLR111W,YLR112W,YLR113W,YLR114C,YLR115W,YLR116W,YLR117C,YLR118C,YLR119W	0	0	11	11
chrXII	386511	388221	WGDCluster	YLR120C	0	1	0	1
chrXII	388672	399434	Complement	YLR120W-A,YLR121C,YLR122C,YLR123C,YLR124W,YLR125W,YLR126C,YLR127C,YLR128W	0	0	9	9
chrXII	399657	404063	SSDCluster	YLR129W,YLR130C	2	0	0	2
chrXII	404510	416659	WGDCluster	YLR131C,YLR132C,YLR133W,YLR134W,YLR135W,YLR136C	1	3	2	6
chrXII	417006	429387	Complement	YLR137W,YLR138W,YLR139C,YLR140W,YLR141W,YLR142W,YLR143W	0	0	7	7
chrXII	429677	433726	SSDCluster	YLR144C,YLR145W,YLR146C	2	0	1	3
chrXII	433870	444689	Complement	YLR146W-A,YLR147C,YLR148W,YLR149C,YLR149C-A,YLR150W,YLR151C,YLR152C	0	0	8	8
chrXII	445524	452624	SSDCluster	YLR153C,YLR154C,RDN37-1,RDN25-1,YLR154W-A	4	0	1	5
chrXII	454392	482038	Complement	YLR154W-B,YLR154W-C,RDN58-1,YLR154W-E,YLR154W-F,RDN18-1,RDN5-1,RDN25-2,RDN37-2,YLR154C-G,RDN58-2,RDN18-2,RDN5-2,YLR154C-H,YLR155C,YLR156W,RDN5-3,YLR156C-A,YLR157C,YLR157W-D,YLR157C-B,YLR157C-A,YLR157W-E	0	0	23	23
chrXII	482045	501124	SSDCluster	RDN5-4,YLR157C-C,YLR158C,YLR159W,RDN5-5,YLR159C-A,YLR160C,YLR161W,RDN5-6,YLR162W,YLR162W-A,YLR163C,YLR163W-A,YLR164W,YLR165C,YLR166C,YLR167W,YLR168C,YLR169W,YLR170C,YLR171W	13	2	6	21
chrXII	501261	504249	Complement	YLR172C,YLR173W	0	0	2	2
chrXII	504592	527947	WGDCluster	YLR174W,YLR175W,YLR176C,YLR177W,YLR178C,YLR179C,YLR180W,YLR181C,YLR182W,YLR183C,YLR184W,YLR185W,YLR186W,YLR187W	2	5	7	14
chrXII	528301	530389	SSDCluster	YLR188W	1	0	0	1
chrXII	530798	545700	Complement	YLR189C,YLR190W,YLR191W,YLR192C,YLR193C,YLR194C,YLR195C,YLR196W	0	0	8	8
chrXII	546098	547647	SSDCluster	YLR197W,YLR198C	2	0	0	2
chrXII	547854	553679	Complement	YLR199C,YLR200W,YLR201C,YLR202C,YLR203C,YLR204W,YLR205C	0	0	7	7
chrXII	554579	556421	WGDCluster	YLR206W	0	1	0	1
chrXII	556789	559291	Complement	YLR207W	0	0	1	1
chrXII	559552	581773	SSDCluster	YLR208W,YLR209C,YLR210W,YLR211C,YLR212C,YLR213C,YLR214W,YLR215C,YLR216C,YLR217W,YLR218C,YLR219W,YLR220W,YLR221C,YLR222C	6	1	8	15
chrXII	582007	588920	WGDCluster	YLR222C-A,YLR223C,YLR224W,YLR225C	0	3	1	4
chrXII	589355	598708	Complement	YLR226W,YLR227C,YLR227W-A,YLR227W-B	0	0	4	4
chrXII	600020	616193	WGDCluster	YLR228C,YLR229C,YLR230W,YLR231C,YLR232W,YLR233C,YLR234W,YLR235C,YLR236C,YLR237W,YLR238W	1	3	7	11
chrXII	616333	623885	Complement	YLR239C,YLR240W,YLR241W,YLR242C	0	0	4	4
chrXII	624204	628199	SSDCluster	YLR243W,YLR244C,YLR245C,YLR246W	2	0	2	4
chrXII	628685	633356	Complement	YLR247C	0	0	1	1
chrXII	634253	639916	WGDCluster	YLR248W,YLR249W	0	2	0	2
chrXII	640318	641023	Complement	YLR250W	0	0	1	1
chrXII	641465	644338	SSDCluster	YLR251W,YLR252W,YLR253W	3	0	0	3
chrXII	644405	659793	Complement	YLR254C,YLR255C,YLR256W,YLR256W-A,YLR257W	0	0	5	5
chrXII	660717	707042	WGDCluster	YLR258W,YLR259C,YLR260W,YLR261C,YLR262C,YLR262C-A,YLR263W,YLR264W,YLR264C-A,YLR265C,YLR266C,YLR267W,YLR268W,YLR269C,YLR270W,YLR271W,YLR272C,YLR273C,YLR274W,YLR275W,YLR276C,YLR277C,YLR278C,YLR279W,YLR280C,YLR281C,YLR282C,YLR283W,YLR284C	1	9	19	29
chrXII	707361	717980	Complement	YLR285W,YLR285C-A,YLR286C,YLR286W-A,YLR287C,YLR287C-A,YLR288C,YLR289W,YLR290C	0	0	9	9
chrXII	718318	719464	SSDCluster	YLR291C	1	0	0	1
chrXII	719790	720372	Complement	YLR292C	0	0	1	1
chrXII	720772	730303	WGDCluster	YLR293C,YLR294C,YLR295C,YLR296W,YLR297W,YLR298C,YLR299W,YLR299C-A,YLR300W	0	2	7	9
chrXII	730826	733878	Complement	YLR301W,YLR302C,YLR303W	0	0	3	3
chrXII	735213	748877	SSDCluster	YLR304C,YLR305C,YLR306W,YLR307W,YLR307C-A,YLR308W	4	0	2	6
chrXII	749035	760243	Complement	YLR309C,YLR310C,YLR311C,YLR312C,YLR312W-A	0	0	5	5
chrXII	760356	762342	WGDCluster	YLR313C	0	1	0	1
chrXII	762574	776304	Complement	YLR314C,YLR315W,YLR316C,YLR317W,YLR318W,YLR319C,YLR320W	0	0	7	7
chrXII	776583	777942	SSDCluster	YLR321C,YLR322W	2	0	0	2
chrXII	778172	778952	Complement	YLR323C	0	0	1	1
chrXII	779214	795899	WGDCluster	YLR324W,YLR325C,YLR326W,YLR327C,YLR328W,YLR329W,YLR330W,YLR331C,YLR332W,YLR333C	0	6	4	10
chrXII	796697	805203	Complement	YLR334C,YLR335W,YLR336C,YLR337C,YLR338W	0	0	5	5
chrXII	805783	830363	SSDCluster	YLR339C,YLR340W,YLR341W,YLR342W,YLR342W-A,YLR343W,YLR344W,YLR345W,YLR346C,YLR347C,YLR347W-A,YLR348C,YLR349W,YLR350W,YLR351C	8	4	3	15
chrXII	831114	833538	Complement	YLR352W	0	0	1	1
chrXII	834350	844049	WGDCluster	YLR353W,YLR354C,YLR355C,YLR356W,YLR357W,YLR358C	0	5	1	6
chrXII	844280	845729	Complement	YLR359W	0	0	1	1
chrXII	846101	857316	SSDCluster	YLR360W,YLR361C,YLR361C-A,YLR362W,YLR363C,YLR363W-A,YLR364W,YLR365W,YLR364C-A,YLR366W,YLR367W	4	0	7	11
chrXII	857538	862253	Complement	YLR368W,YLR369W,YLR370C	0	0	3	3
chrXII	862712	872727	WGDCluster	YLR371W,YLR372W,YLR373C,YLR374C,YLR375W	0	4	1	5
chrXII	872824	874791	Complement	YLR376C,YLR377C	0	0	2	2
chrXII	875734	919019	SSDCluster	YLR378C,YLR379W,YLR380W,YLR381W,YLR382C,YLR383W,YLR384C,YLR385C,YLR386W,YLR387C,YLR388W,YLR389C,YLR390W,YLR390W-A,YLR392C,YLR393W,YLR394W,YLR395C,YLR396C,YLR397C,YLR398C	7	1	13	21
chrXII	919535	920973	WGDCluster	YLR399C,YLR399W-A	0	2	0	2
chrXII	922062	929599	Complement	YLR400W,YLR401C,YLR402W,YLR403W,YLR404W	0	0	5	5
chrXII	929787	930891	SSDCluster	YLR405W	1	0	0	1
chrXII	931063	950470	Complement	YLR406C,YLR406C-A,YLR407W,YLR408C,YLR409C,YLR410W,YLR410W-B,YLR410W-A,YLR411W,YLR412W,YLR412C-A	0	0	11	11
chrXII	951152	953180	WGDCluster	YLR413W	0	1	0	1
chrXII	953349	1000792	Complement	YLR414C,YLR415C,YLR416C,YLR417W,YLR418C,YLR419W,YLR420W,YLR421C,YLR422W,YLR423C,YLR424W,YLR425W,YLR426W,YLR427W,YLR428C,YLR429W,YLR430W,YLR431C	0	0	18	18
chrXII	1002553	1056833	WGDCluster	YLR432W,YLR433C,YLR434C,YLR435W,YLR436C,YLR437C,YLR437C-A,YLR438W,YLR438C-A,YLR439W,YLR440C,YLR441C,YLR442C,YLR443W,YLR444C,YLR445W,YLR446W,YLR447C,YLR448W,YLR449W,YLR450W,YLR451W,YLR452C,YLR453C,YLR454W,YLR455W,YLR456W,YLR457C,YLR458W	4	12	13	29
chrXII	1057331	1058516	Complement	YLR459W	0	0	1	1
chrXII	1059754	1077530	SSDCluster	YLR460C,YLR461W,YLR462W,YLR463C,YLR464W,YLR465C,YLR466W,YLR466C-A,YLR466C-B,YLR467W,YLR467C-A	7	0	4	11
chrXIII	460	8383	SSDCluster	YML133C,YML133W-B,YML133W-A,YML132W	4	0	0	4
chrXIII	9698	20536	Complement	YML131W,YML130C,YML129C,YML128C,YML127W,YML126C	0	0	6	6
chrXIII	20761	21700	WGDCluster	YML125C	0	1	0	1
chrXIII	22048	23684	Complement	YML124C	0	0	1	1
chrXIII	24037	41794	SSDCluster	YML123C,YML122C,YML121W,YML120C,YML119W,YML118W,YML117W,YML116W-A,YML116W,YML115C	5	2	3	10
chrXIII	42042	45953	Complement	YML114C,YML113W,YML112W	0	0	3	3
chrXIII	46941	57453	WGDCluster	YML111W,YML110C,YML109W,YML108W,YML107C,YML106W	0	3	3	6
chrXIII	57865	67549	Complement	YML105C,YML104C,YML103C	0	0	3	3
chrXIII	68293	86739	SSDCluster	YML102W,YML101C-A,YML101C,YML100W-A,YML100W,YML099W-A,YML099C,YML098W,YML097C,YML096W,YML095C,YML094C-A,YML094W,YML093W,YML092C	5	2	8	15
chrXIII	87122	94241	Complement	YML091C,YML090W,YML089C,YML088W	0	0	4	4
chrXIII	94430	121324	WGDCluster	YML087C,YML086C,YML085C,YML084W,YML083C,YML082W,YML081C-A,YML081W,YML080W,YML079W,YML078W,YML077W,YML076C,YML075C,YML074C	2	5	8	15
chrXIII	123226	131572	Complement	YML073C,YML072C,YML071C	0	0	3	3
chrXIII	133474	151532	SSDCluster	YML070W,YML069W,YML068W,YML067C,YML066C,YML065W,YML064C,YML063W,YML062C,YML061C	3	2	5	10
chrXIII	151870	158966	Complement	YML060W,YML059C,YML058W-A	0	0	3	3
chrXIII	159382	164176	WGDCluster	YML058W,YML057C-A,YML057W,YML056C	0	4	0	4
chrXIII	164789	172901	Complement	YML055W,YML054C,YML054C-A,YML053C,YML052W,YML051W	0	0	6	6
chrXIII	173138	183363	SSDCluster	YML050W,YML049C,YML048W,YML047W-A,YML047C,YML046W	2	2	2	6
chrXIII	184460	208860	Complement	YML045W-A,YML045W,YML043C,YML042W,YML041C,YML040W,YML039W,YML038C,YML037C,YML036W,YML035C	0	0	11	11
chrXIII	209427	241536	WGDCluster	YML034C-A,YML034W,YML032C,YML031C-A,YML031W,YML030W,YML029W,YML028W,YML027W,YML026C,YML025C,YML024W,YML023C,YML022W,YML021C,YML020W,YML019W,YML018C,YML017W,YML016C	0	7	13	20
chrXIII	241988	253272	Complement	YML015C,YML014W,YML013W,YML012C-A,YML012W,YML011C,YML010W,YML009W-B,YML009C-A,YML009C,YML008C,YML007C-A	0	0	12	12
chrXIII	253847	255800	WGDCluster	YML007W	0	1	0	1
chrXIII	256091	277211	Complement	YML006C,YML005W,YML004C,YML003W,YML002W,YML001W,YMR001C,YMR001C-A,YMR002W,YMR003W,YMR004W,YMR005W	0	0	12	12
chrXIII	277560	289703	SSDCluster	YMR006C,YMR007W,YMR008C,YMR009W,YMR010W,YMR011W	2	1	3	6
chrXIII	291132	300426	Complement	YMR012W,YMR013C,YMR013C-A,YMR013W-A,YMR014W	0	0	5	5
chrXIII	300867	319176	SSDCluster	YMR015C,YMR016C,YMR017W,YMR018W,YMR019W,YMR020W,YMR021C,YMR022W	4	1	3	8
chrXIII	319435	331922	Complement	YMR023C,YMR024W,YMR025W,YMR026C,YMR027W,YMR028W,YMR029C,YMR030W	0	0	8	8
chrXIII	332210	350862	WGDCluster	YMR031C,YMR031W-A,YMR032W,YMR030W-A,YMR033W,YMR034C,YMR035W,YMR036C,YMR037C,YMR038C,YMR039C,YMR040W	2	4	6	12
chrXIII	350964	351972	Complement	YMR041C	0	0	1	1
chrXIII	352601	354730	SSDCluster	YMR042W,YMR043W	2	0	0	2
chrXIII	355382	362829	Complement	YMR044W,YMR045C,YMR046C,YMR046W-A	0	0	4	4
chrXIII	363362	366704	WGDCluster	YMR047C	0	1	0	1
chrXIII	366979	380199	Complement	YMR048W,YMR049C,YMR050C,YMR051C,YMR052W	0	0	5	5
chrXIII	380067	382897	WGDCluster	YMR052C-A,YMR053C	0	2	0	2
chrXIII	383301	390731	SSDCluster	YMR054W,YMR055C,YMR056C,YMR057C,YMR058W	2	0	3	5
chrXIII	391097	411264	Complement	YMR059W,YMR060C,YMR061W,YMR062C,YMR063W,YMR064W,YMR065W,YMR066W,YMR067C,YMR068W,YMR069W,YMR070W,YMR071C	0	0	13	13
chrXIII	411567	412119	WGDCluster	YMR072W	0	1	0	1
chrXIII	412266	422148	Complement	YMR073C,YMR074C,YMR075W,YMR075C-A,YMR076C,YMR077C	0	0	6	6
chrXIII	422501	451364	SSDCluster	YMR078C,YMR079W,YMR080C,YMR081C,YMR082C,YMR083W,YMR084W,YMR085W,YMR086W,YMR086C-A,YMR087W,YMR088C,YMR089C,YMR090W,YMR091C	6	4	5	15
chrXIII	451630	468161	Complement	YMR092C,YMR093W,YMR094W,YMR095C,YMR096W,YMR097C,YMR098C,YMR099C,YMR100W	0	0	9	9
chrXIII	468443	469475	SSDCluster	YMR101C	1	0	0	1
chrXIII	469846	517286	WGDCluster	YMR102C,YMR103C,YMR104C,YMR105C,YMR105W-A,YMR106C,YMR107W,YMR108W,YMR109W,YMR110C,YMR111C,YMR112C,YMR113W,YMR114C,YMR115W,YMR116C,YMR117C,YMR118C,YMR119W,YMR119W-A,YMR120C,YMR121C,YMR122C,YMR122W-A,YMR123W,YMR124W	1	12	13	26
chrXIII	517537	545729	Complement	YMR125W,YMR126C,YMR127C,YMR128W,YMR129W,YMR130W,YMR131C,YMR132C,YMR133W,YMR134W,YMR135C,YMR135W-A,YMR136W,YMR137C,YMR138W	0	0	15	15
chrXIII	546123	565908	WGDCluster	YMR139W,YMR140W,YMR141C,YMR142C,YMR141W-A,YMR143W,YMR144W,YMR145C,YMR146C,YMR147W,YMR148W,YMR149W,YMR150C,YMR151W,YMR152W,YMR153W,YMR153C-A	2	6	9	17
chrXIII	565997	592627	Complement	YMR154C,YMR155W,YMR156C,YMR157C,YMR158W,YMR158C-A,YMR158W-B,YMR159C,YMR160W,YMR161W,YMR162C,YMR163C,YMR164C,YMR165C	0	0	14	14
chrXIII	593365	608210	SSDCluster	YMR166C,YMR167W,YMR168C,YMR169C,YMR170C,YMR171C,YMR172W,YMR172C-A	7	0	1	8
chrXIII	608687	610364	Complement	YMR173W,YMR173W-A,YMR174C	0	0	3	3
chrXIII	611014	634471	WGDCluster	YMR175W,YMR175W-A,YMR176W,YMR177W,YMR178W,YMR179W,YMR180C,YMR181C,YMR182C,YMR182W-A,YMR183C,YMR184W,YMR185W,YMR186W	0	7	7	14
chrXIII	634687	646776	Complement	YMR187C,YMR188C,YMR189W,YMR190C,YMR191W	0	0	5	5
chrXIII	647116	664283	WGDCluster	YMR192W,YMR193W,YMR193C-A,YMR194W,YMR194C-B,YMR194C-A,YMR195W,YMR196W,YMR197C,YMR198W,YMR199W	0	4	7	11
chrXIII	664750	671324	Complement	YMR200W,YMR201C,RNA170,YMR202W,YMR203W,YMR204C	0	0	6	6
chrXIII	671885	674765	SSDCluster	YMR205C	1	0	0	1
chrXIII	675894	683563	WGDCluster	YMR206W,YMR207C	0	2	0	2
chrXIII	684465	693042	Complement	YMR208W,YMR209C,YMR210W,YMR211W,YMR212C	0	0	5	5
chrXIII	693379	698369	SSDCluster	YMR213W,YMR214W,YMR215W	2	0	1	3
chrXIII	698809	715444	Complement	YMR216C,YMR217W,YMR218C,YMR219W,YMR220W,YMR221C	0	0	6	6
chrXIII	715636	716308	WGDCluster	YMR222C	0	1	0	1
chrXIII	716713	721402	Complement	YMR223W,YMR224C,YMR225C	0	0	3	3
chrXIII	721591	722395	SSDCluster	YMR226C	1	0	0	1
chrXIII	722611	738958	Complement	YMR227C,YMR228W,YMR229C,YMR230W,YMR230W-A,YMR231W,YMR232W	0	0	7	7
chrXIII	739183	756165	WGDCluster	YMR233W,YMR234W,YMR235C,YMR236W,YMR237W,YMR238W,YMR239C,YMR240C,YMR241W,YMR242C,YMR242W-A,YMR243C	1	4	7	12
chrXIII	757248	759182	Complement	YMR244W,YMR244C-A,YMR245W	0	0	3	3
chrXIII	759805	777189	SSDCluster	YMR246W,YMR247C,YMR247W-A,YMR250W,YMR251W,YMR251W-A,YMR252C,YMR253C	4	0	4	8
chrXIII	777613	789838	Complement	YMR254C,YMR255W,YMR256C,YMR257C,YMR258C,YMR259C,YMR260C	0	0	7	7
chrXIII	790203	796415	WGDCluster	YMR261C,YMR262W,YMR263W,YMR264W	0	2	2	4
chrXIII	796538	797924	Complement	YMR265C	0	0	1	1
chrXIII	798516	810578	SSDCluster	YMR266W,YMR267W,YMR268C,YMR269W,YMR270C,YMR271C,YMR272C,YMR272W-A	4	1	3	8
chrXIII	811087	811195	Complement	YMR272W-B	0	0	1	1
chrXIII	811231	826350	WGDCluster	YMR273C,YMR274C,YMR275C,YMR276W,YMR277W,YMR278W,YMR279C	0	3	4	7
chrXIII	827026	831328	SSDCluster	YMR280C	1	0	0	1
chrXIII	832337	839994	Complement	YMR281W,YMR282C,YMR283C,YMR284W	0	0	4	4
chrXIII	840142	841690	WGDCluster	YMR285C	0	1	0	1
chrXIII	841940	849808	Complement	YMR286W,YMR287C,YMR288W,YMR289W	0	0	4	4
chrXIII	850072	851768	SSDCluster	YMR290C,YMR290W-A	2	0	0	2
chrXIII	852628	858086	Complement	YMR291W,YMR292W,YMR293C,YMR294W	0	0	4	4
chrXIII	858207	858889	WGDCluster	YMR294W-A,YMR295C	0	2	0	2
chrXIII	859213	860890	Complement	YMR296C	0	0	1	1
chrXIII	861920	874336	SSDCluster	YMR297W,YMR298W,YMR299C,YMR300C,YMR301C,YMR302C,YMR303C	2	0	5	7
chrXIII	874985	878678	Complement	YMR304W	0	0	1	1
chrXIII	878778	880231	WGDCluster	YMR304C-A,YMR305C	0	2	0	2
chrXIII	881157	886571	Complement	YMR306W,YMR306C-A	0	0	2	2
chrXIII	887001	892220	SSDCluster	YMR307W,YMR307C-A,YMR308C	3	0	0	3
chrXIII	892986	895425	Complement	YMR309C	0	0	1	1
chrXIII	895714	896668	WGDCluster	YMR310C	0	1	0	1
chrXIII	896912	904392	Complement	YMR311C,YMR312W,YMR313C,YMR314W,YMR315W,YMR315W-A	0	0	6	6
chrXIII	904822	912141	SSDCluster	YMR316W,YMR316C-A,YMR316C-B,YMR317W,YMR318C	3	0	2	5
chrXIII	912877	923800	Complement	YMR319C,YMR320W,YMR321C,YMR322C,YMR323W,YMR324C,YMR325W,YMR326C	0	0	8	8
chrXIV	370	7419	Complement	YNL339C,YNL339W-B,YNL339W-A,YNL338W,YNL337W	0	0	5	5
chrXIV	8329	23274	SSDCluster	YNL336W,YNL335W,YNL334C,YNL333W,YNL332W,YNL331C,YNL330C,YNL329C,YNL328C	5	2	2	9
chrXIV	24046	34234	Complement	YNL327W,YNL326C,YNL325C,YNL324W,YNL323W,YNL322C	0	0	6	6
chrXIV	34694	37421	SSDCluster	YNL321W	1	0	0	1
chrXIV	37698	52430	Complement	YNL320W,YNL319W,YNL318C,YNL317W,YNL316C,YNL315C,YNL314W,YNL313C,YNL312W,YNL311C,YNL310C	0	0	11	11
chrXIV	52660	82541	WGDCluster	YNL309W,YNL308C,YNL307C,YNL306W,YNL305C,YNL304W,YNL303W,YNL302C,YNL301C,YNL300W,YNL299W,YNL298W,YNL297C,YNL296W,YNL295W,YNL294C,YNL293W	0	6	11	17
chrXIV	82805	85815	Complement	YNL292W,YNL291C	0	0	2	2
chrXIV	86217	94801	SSDCluster	YNL290W,YNL289W,YNL288W,YNL287W	2	0	2	4
chrXIV	95222	104102	Complement	YNL286W,YNL285W,YNL284C-B,YNL284C-A,YNL284C	0	0	5	5
chrXIV	105183	106695	WGDCluster	YNL283C	0	1	0	1
chrXIV	107686	108274	Complement	YNL282W	0	0	1	1
chrXIV	108466	110411	SSDCluster	YNL281W,YNL280C	2	0	0	2
chrXIV	110916	112902	Complement	YNL279W	0	0	1	1
chrXIV	113270	116453	WGDCluster	YNL278W	0	1	0	1
chrXIV	116678	129084	Complement	YNL277W-A,YNL277W,YNL276C,YNL275W,YNL274C,YNL273W,YNL272C	0	0	7	7
chrXIV	129522	146616	SSDCluster	YNL271C,YNL270C,YNL269W,YNL268W,YNL267W,YNL266W,YNL265C,YNL264C	3	1	4	8
chrXIV	146896	160374	Complement	YNL263C,YNL262W,YNL261W,YNL260C,YNL259C,YNL258C	0	0	6	6
chrXIV	160631	164321	WGDCluster	YNL257C	0	1	0	1
chrXIV	164623	179349	Complement	YNL256W,YNL255C,YNL254C,YNL253W,YNL252C,YNL251C,YNL250W	0	0	7	7
chrXIV	179394	181023	SSDCluster	YNL249C	1	0	0	1
chrXIV	181361	204873	Complement	YNL248C,YNL247W,YNL246W,YNL245C,YNL244C,YNL243W,YNL242W,YNL241C,YNL240C,YNL239W,YNL238W	0	0	11	11
chrXIV	205188	217043	SSDCluster	YNL237W,YNL236W,YNL235C,YNL234W,YNL233W,YNL232W,YNL231C	2	0	5	7
chrXIV	217523	222650	Complement	YNL230C,YNL229C,YNL228W,YNL227C,YNL226W	0	0	5	5
chrXIV	222724	224470	WGDCluster	YNL225C	0	1	0	1
chrXIV	224796	251744	Complement	YNL224C,YNL223W,YNL222W,YNL221C,YNL220W,YNL219C,YNL218W,YNL217W,YNL216W,YNL215W,YNL214W,YNL213C,YNL212W,YNL211C,YNL210W	0	0	15	15
chrXIV	252059	273616	WGDCluster	YNL209W,YNL208W,YNL207W,YNL206C,YNL205C,YNL204C,YNL203C,YNL202W,YNL201C,YNL200C,YNL199C,YNL198C,YNL197C,YNL196C,YNL195C,YNL194C	2	6	8	16
chrXIV	274368	276045	Complement	YNL193W	0	0	1	1
chrXIV	276502	285889	SSDCluster	YNL192W,YNL191W,YNL190W,YNL189W	2	0	2	4
chrXIV	286308	292885	Complement	YNL188W,YNL187W,YNL186W,YNL185C,YNL184C	0	0	5	5
chrXIV	293138	310059	WGDCluster	YNL183C,YNL182C,YNL181W,YNL180C,YNL179C,YNL178W,YNL177C,YNL176C,YNL175C,YNL174W,YNL173C	0	3	8	11
chrXIV	310637	315999	Complement	YNL172W,YNL171C	0	0	2	2
chrXIV	315979	317673	SSDCluster	YNL170W,YNL169C	2	0	0	2
chrXIV	318031	334869	Complement	YNL168C,YNL167C,YNL166C,YNL165W,YNL164C,YNL163C,YNL162W-A,YNL162W,YNL161W	0	0	9	9
chrXIV	336546	353146	WGDCluster	YNL160W,YNL159C,YNL158W,YNL157W,YNL156C,YNL155W,YNL154C,YNL153C,YNL152W,YNL151C,YNL150W,YNL149C,YNL148C,YNL147W,YNL146C-A,YNL146W,YNL145W,YNL144C,YNL144W-A	2	6	11	19
chrXIV	356795	371647	Complement	YNL143C,YNL142W,YNL141W,YNL140C,YNL139C,YNL138W-A,YNL138W,YNL137C,YNL136W	0	0	9	9
chrXIV	371883	372228	SSDCluster	YNL135C	1	0	0	1
chrXIV	372452	389769	Complement	YNL134C,YNL133C,YNL132W,YNL131W,YNL130C,YNL130C-A,YNL129W,YNL128W,YNL127W,YNL126W	0	0	10	10
chrXIV	390147	392169	SSDCluster	YNL125C	1	0	0	1
chrXIV	392893	398372	Complement	YNL124W,YNL123W,YNL122C	0	0	3	3
chrXIV	398685	426810	WGDCluster	YNL121C,YNL120C,YNL119W,YNL118C,YNL117W,YNL116W,YNL115C,YNL114C,YNL113W,YNL112W,YNL111C,YNL110C,YNL109W,YNL108C,YNL107W,YNL106C,YNL105W,YNL104C,YNL103W-A	2	8	9	19
chrXIV	427736	434495	Complement	YNL103W,YNL102W	0	0	2	2
chrXIV	435000	441588	SSDCluster	YNL101W,YNL100W,YNL099C,YNL098C,YNL097C-B,YNL097C,YNL097W-A	3	1	3	7
chrXIV	443399	450532	WGDCluster	YNL096C,YNL095C,YNL094W,YNL093W	0	3	1	4
chrXIV	450872	461992	Complement	YNL092W,YNL091W,YNL090W,YNL089C,YNL088W	0	0	5	5
chrXIV	462412	465949	WGDCluster	YNL087W	0	1	0	1
chrXIV	466335	472863	Complement	YNL086W,YNL085W,YNL084C,YNL083W	0	0	4	4
chrXIV	473392	492973	SSDCluster	YNL082W,YNL081C,YNL080C,YNL079C,YNL078W,YNL077W,YNL076W,YNL075W,YNL074C,YNL073W,YNL072W,YNL071W	5	2	5	12
chrXIV	493367	495003	Complement	YNL070W,YNL069C	0	0	2	2
chrXIV	495702	518847	WGDCluster	YNL068C,YNL067W-A,YNL067W-B,YNL067W,YNL066W,YNL065W,YNL064C,YNL063W,YNL062C,YNL061W,YNL059C,YNL058C,YNL057W,YNL056W,YNL055C	4	6	5	15
chrXIV	519457	529585	Complement	YNL054W-A,YNL054W-B,YNL054W	0	0	3	3
chrXIV	529943	541883	WGDCluster	YNL053W,YNL052W,YNL051W,YNL050C,YNL049C,YNL048W,YNL047C	1	4	2	7
chrXIV	542305	557785	Complement	YNL046W,YNL045W,YNL044W,YNL043C,YNL042W-B,YNL042W,YNL041C,YNL040W,YNL039W,YNL038W	0	0	10	10
chrXIV	557921	559004	SSDCluster	YNL037C	1	0	0	1
chrXIV	559815	569693	Complement	YNL036W,YNL035C	0	0	2	2
chrXIV	570478	587849	SSDCluster	YNL034W,YNL033W,YNL032W,YNL031C,YNL030W,YNL029C,YNL028W,YNL027W,YNL026W,YNL025C,NME1,YNL024C-A,YNL024C	7	2	4	13
chrXIV	588264	595349	Complement	YNL023C,YNL022C,YNL021W	0	0	3	3
chrXIV	595624	633859	WGDCluster	YNL020C,YNL019C,YNL018C,YNL017C,YNL016W,YNL015W,YNL014W,YNL013C,YNL012W,YNL011C,YNL010W,YNL009W,YNL008C,YNL007C,YNL006W,YNL005C,YNL004W,YNL003C,YNL002C,YNL001W,YNR001C,YNR001W-A,YNR002C	3	9	11	23
chrXIV	634346	636386	Complement	YNR003C,YNR003W-A,YNR004W	0	0	3	3
chrXIV	636933	648940	SSDCluster	YNR005C,YNR006W,YNR007C,YNR008W,YNR009W,YNR010W,YNR011C,YNR012W	3	0	5	8
chrXIV	649030	651715	Complement	YNR013C	0	0	1	1
chrXIV	652467	692860	WGDCluster	YNR014W,YNR015W,YNR016C,YNR017W,YNR018W,YNR019W,YNR020C,YNR021W,YNR022C,YNR023W,YNR024W,YNR025C,YNR026C,YNR027W,YNR028W,YNR029C,YNR030W,YNR031C,YNR032W,YNR032C-A,YNR033W,YNR034W,YNR034W-A	2	9	12	23
chrXIV	693021	703088	Complement	YNR035C,YNR036C,YNR037C,YNR038W,YNR039C,YNR040W,YNR041C,YNR042W,YNR043W	0	0	9	9
chrXIV	703701	712814	WGDCluster	YNR044W,YNR045W,YNR046W,YNR047W,YNR048W	0	3	2	5
chrXIV	713025	720650	Complement	YNR049C,YNR050C,YNR051C,YNR052C	0	0	4	4
chrXIV	721122	738546	SSDCluster	YNR053C,YNR054C,YNR055C,YNR056C,YNR057C,YNR058W,YNR059W	3	0	4	7
chrXIV	739951	742111	WGDCluster	YNR060W	0	1	0	1
chrXIV	742881	755036	Complement	YNR061C,YNR062C,YNR063W,YNR064C,YNR065C,YNR066C	0	0	6	6
chrXIV	755746	782281	SSDCluster	YNR067C,YNR068C,YNR069C,YNR070W,YNR071C,YNR072W,YNR073C,YNR074C,YNR075W,YNR075C-A,YNR076W	6	0	5	11
chrXIV	783287	783542	Complement	YNR077C	0	0	1	1
chrXV	84	8115	Complement	YOL166W-A,YOL166C,YOL165C,YOL164W-A,YOL164W	0	0	5	5
chrXV	9617	10605	SSDCluster	YOL162W,YOL163W	2	0	0	2
chrXV	11547	24293	Complement	YOL161C,YOL160W,YOL159C-A,YOL159C,YOL158C,YOL157C	0	0	6	6
chrXV	25271	31605	SSDCluster	YOL156W,YOL155W-A,YOL155C	2	0	1	3
chrXV	34656	42609	Complement	YOL154W,YOL153C,YOL152W	0	0	3	3
chrXV	43692	44783	SSDCluster	YOL151W,YOL150C	2	0	0	2
chrXV	44936	56279	Complement	YOL149W,YOL148C,YOL147C,YOL146W,YOL145C,YOL144W,YOL143C,YOL142W	0	0	8	8
chrXV	56450	60030	SSDCluster	YOL141W,YOL140W	2	0	0	2
chrXV	60382	70690	Complement	YOL139C,YOL138C,YOL137W,YOL136C,YOL135C,YOL134C,YOL133W	0	0	7	7
chrXV	71299	72715	SSDCluster	YOL132W	1	0	0	1
chrXV	73030	79479	WGDCluster	YOL131W,YOL130W,YOL129W,YOL128C	1	2	1	4
chrXV	80347	89448	Complement	YOL127W,YOL126C,YOL125W,YOL124C,YOL123W	0	0	5	5
chrXV	89691	91419	SSDCluster	YOL122C	1	0	0	1
chrXV	92025	132508	WGDCluster	YOL121C,YOL120C,YOL119C,YOL118C,YOL117W,YOL116W,YOL115W,YOL114C,YOL113W,YOL112W,YOL111C,YOL110W,YOL109W,YOL108C,YOL107W,YOL106W,YOL105C,YOL104C,YOL103W-B,YOL103W-A,YOL103W,YOL102C,YOL101C,YOL100W,YOL099C	2	10	13	25
chrXV	132724	142555	SSDCluster	YOL098C,YOL097W-A,YOL097C,YOL096C,YOL095C,YOL094C	3	0	3	6
chrXV	142814	143696	Complement	YOL093W	0	0	1	1
chrXV	144203	160594	WGDCluster	YOL092W,YOL091W,YOL090W,YOL089C,YOL088C,YOL087C,YOL086W-A,YOL086C	0	4	4	8
chrXV	161578	162014	Complement	YOL085W-A,YOL085C	0	0	2	2
chrXV	162355	169974	SSDCluster	YOL084W,YOL083W,YOL083C-A,YOL082W	4	0	0	4
chrXV	171069	204471	WGDCluster	YOL081W,YOL080C,YOL079W,YOL078W,YOL077W-A,YOL077C,YOL076W,YOL075C,YOL073C,YOL072W,YOL071W,YOL070C,YOL069W,YOL068C,YOL067C,YOL066C	0	4	12	16
chrXV	204730	210265	Complement	YOL065C,YOL064C,YOL063C	0	0	3	3
chrXV	210519	211995	SSDCluster	YOL062C	1	0	0	1
chrXV	212243	216137	Complement	YOL061W,YOL060C	0	0	2	2
chrXV	217125	224178	WGDCluster	YOL059W,YOL058W,YOL057W,YOL056W	0	2	2	4
chrXV	224418	229833	SSDCluster	YOL055C,YOL054W	2	0	0	2
chrXV	230083	240093	Complement	YOL053W,YOL052C-A,YOL052C,YOL051W,YOL050C,YOL049W	0	0	6	6
chrXV	240202	259104	WGDCluster	YOL048C,YOL047C,YOL046C,YOL045W,YOL044W,YOL043C,YOL042W,YOL041C,YOL040C,YOL039W,YOL038C-A,YOL038W,YOL037C,YOL036W,YOL035C	2	7	6	15
chrXV	259923	285427	SSDCluster	YOL034W,YOL033W,YOL032W,YOL031C,YOL030W,YOL029C,YOL028C,YOL027C,YOL026C,YOL025W,YOL024W,YOL023W,YOL022C,YOL021C	4	2	8	14
chrXV	286172	288573	Complement	YOL020W,YOL019W-A	0	0	2	2
chrXV	288898	307410	WGDCluster	YOL019W,YOL018C,YOL017W,YOL016C,YOL015W,YOL014W,YOL013W-B,YOL013W-A,YOL013C,YOL012C,YOL011W	1	4	6	11
chrXV	307938	322995	Complement	YOL010W,YOL009C,YOL008W,YOL007C,YOL006C,YOL005C,YOL004W,YOL003C	0	0	8	8
chrXV	323411	353863	SSDCluster	YOL002C,YOL001W,YOR001W,YOR002W,YOR003W,YOR004W,YOR005C,YOR006C,YOR007C,YOR008C,YOR008C-A,YOR008W-B,YOR009W,YOR010C,YOR011W	7	1	7	15
chrXV	355651	360352	Complement	YOR011W-A,YOR012W,YOR013W,YOR014W,YOR015W	0	0	5	5
chrXV	360460	370319	WGDCluster	YOR016C,YOR017W,YOR018W,YOR019W	0	3	1	4
chrXV	370523	378170	Complement	YOR020C,YOR020W-A,YOR021C,YOR022C,YOR023C,YOR024W	0	0	6	6
chrXV	378218	406544	SSDCluster	YOR025W,YOR026W,YOR027W,YOR028C,YOR029W,YOR030W,YOR031W,YOR032C,YOR032W-A,YOR033C,YOR034C,YOR034C-A,YOR035C,YOR036W,YOR037W,YOR038C,YOR039W	6	3	8	17
chrXV	407063	417682	WGDCluster	YOR040W,YOR041C,YOR042W,YOR043W,YOR044W,YOR045W,YOR046C,YOR047C	0	4	4	8
chrXV	418630	421651	SSDCluster	YOR048C	1	0	0	1
chrXV	422668	427226	Complement	YOR049C,YOR050C,YOR051C,YOR052C	0	0	4	4
chrXV	427818	429914	WGDCluster	YOR053W,YOR054C,YOR055W	0	3	0	3
chrXV	430248	441165	Complement	YOR056C,YOR057W,YOR058C,YOR059C,YOR060C	0	0	5	5
chrXV	441535	442555	SSDCluster	YOR061W	1	0	0	1
chrXV	442726	454215	WGDCluster	YOR062C,YOR063W,YOR064C,YOR065W,YOR066W,YOR067C,YOR069W,YOR068C	1	4	3	8
chrXV	455908	457822	SSDCluster	YOR070C	1	0	0	1
chrXV	459481	469254	Complement	YOR071C,YOR072W,YOR072W-A,YOR072W-B,YOR073W,YOR074C,YOR073W-A,YOR075W	0	0	8	8
chrXV	469378	496969	WGDCluster	YOR076C,YOR077W,YOR078W,YOR079C,YOR080W,YOR081C,YOR082C,YOR083W,YOR084W,YOR085W,YOR086C,YOR087W,YOR089C,YOR090C,YOR091W,YOR092W	0	7	9	16
chrXV	497506	507506	Complement	YOR093C,YOR094W,YOR095C,YOR096W,YOR097C	0	0	5	5
chrXV	507948	513007	SSDCluster	YOR098C,YOR099W	2	0	0	2
chrXV	513295	514279	Complement	YOR100C	0	0	1	1
chrXV	515244	530249	WGDCluster	YOR101W,YOR102W,YOR103C,YOR104W,YOR105W,YOR106W,YOR107W,YOR108W,YOR108C-A,YOR109W,YOR110W	0	5	6	11
chrXV	530429	533794	Complement	YOR111W,YOR112W	0	0	2	2
chrXV	534075	544146	SSDCluster	YOR113W,YOR114W,YOR115C,YOR116C	2	0	2	4
chrXV	545029	550247	Complement	YOR117W,YOR118W,YOR119C	0	0	3	3
chrXV	551114	564194	WGDCluster	YOR120W,YOR121C,YOR122C,YOR123C,YOR124C,YOR125C,YOR126C,YOR127W	0	3	5	8
chrXV	564476	574831	Complement	YOR128C,YOR129C,YOR130C,YOR131C,YOR132W	0	0	5	5
chrXV	575098	579794	WGDCluster	YOR133W,YOR134W	0	2	0	2
chrXV	580159	589282	SSDCluster	YOR135C,YOR136W,YOR137C,YOR138C,YOR139C,YOR140W	5	0	1	6
chrXV	589942	606179	Complement	YOR141C,YOR142W,YOR142W-A,YOR142W-B,YOR143C,YOR144C,YOR145C,YOR146W	0	0	8	8
chrXV	606607	616672	SSDCluster	YOR147W,YOR148C,YOR149C,YOR150W,YOR151C	2	0	3	5
chrXV	617518	618289	Complement	YOR152C	0	0	1	1
chrXV	619840	630541	WGDCluster	YOR153W,YOR154W,YOR155C,YOR156C	0	2	2	4
chrXV	630966	648503	SSDCluster	YOR157C,YOR158W,YOR159C,YOR160W,YOR161C,YOR161W-A,YOR161W-B,YOR161C-C,YOR162C,YOR163W,YOR164C,YOR165W,YOR166C	2	0	11	13
chrXV	648804	692033	WGDCluster	YOR167C,YOR168W,YOR169C,YOR170W,YOR171C,YOR172W,YOR173W,YOR174W,YOR175C,YOR176W,YOR177C,YOR178C,YOR179C,YOR180C,YOR181W,YOR182C,YOR183W,YOR184W,YOR185C,YOR186W,YOR186C-A,YOR187W,YOR188W,YOR189W,YOR190W	2	10	13	25
chrXV	692475	700568	SSDCluster	YOR191W,YOR192C	2	0	0	2
chrXV	703988	709733	Complement	YOR192C-C,YOR192C-B,YOR192C-A	0	0	3	3
chrXV	710446	711577	WGDCluster	YOR193W	0	1	0	1
chrXV	711683	722609	Complement	YOR194C,YOR195W,YOR196C,YOR197W,YOR198C,YOR199W,YOR200W,YOR201C,YOR202W	0	0	9	9
chrXV	722565	724726	WGDCluster	YOR203W,YOR204W	0	2	0	2
chrXV	725564	729645	Complement	YOR205C,YOR206W	0	0	2	2
chrXV	730008	736178	SSDCluster	YOR207C,YOR208W	2	0	0	2
chrXV	736437	744182	Complement	YOR209C,YOR210W,YOR211C,YOR212W	0	0	4	4
chrXV	744535	746304	WGDCluster	YOR213C,YOR214C	0	2	0	2
chrXV	746725	748980	Complement	YOR215C,YOR216C	0	0	2	2
chrXV	749301	755010	SSDCluster	YOR217W,YOR218C,YOR219C	3	0	0	3
chrXV	755328	757559	Complement	YOR220W,YOR221C	0	0	2	2
chrXV	758330	783299	WGDCluster	YOR222W,YOR223W,YOR224C,YOR225W,YOR226C,YOR227W,YOR228C,YOR229W,YOR230W,YOR231W,YOR231C-A,YOR232W,YOR233W,YOR234C,YOR235W,YOR236W,YOR237W	2	8	7	17
chrXV	783677	792242	Complement	YOR238W,YOR239W,YOR241W,YOR242C,YOR243C	0	0	5	5
chrXV	792531	793869	SSDCluster	YOR244W	1	0	0	1
chrXV	794076	796794	Complement	YOR245C,YOR246C	0	0	2	2
chrXV	797676	810683	WGDCluster	YOR247W,YOR248W,YOR249C,YOR250C,YOR251C,YOR252W,YOR253W,YOR254C,YOR255W,YOR256C	0	3	7	10
chrXV	811007	866581	SSDCluster	YOR257W,YOR258W,YOR259C,YOR260W,YOR261C,YOR262W,YOR263C,YOR264W,YOR265W,YOR266W,YOR267C,YOR268C,YOR269W,YOR270C,YOR271C,YOR272W,YOR273C,YOR274W,YOR275C,YOR276W,YOR277C,YOR278W,YOR279C,YOR280C,YOR281C,YOR282W,YOR283W,YOR284W,YOR285W,YOR286W,YOR287C,YOR288C,YOR289W,YOR290C,YOR291W,YOR292C	11	1	24	36
chrXV	867096	868950	Complement	YOR293W,YOR293C-A,YOR294W	0	0	3	3
chrXV	869206	880881	WGDCluster	YOR295W,YOR296W,YOR297C,YOR298W,YOR298C-A,YOR299W,YOR300W	0	3	4	7
chrXV	880962	884132	Complement	YOR301W,YOR302W,YOR303W	0	0	3	3
chrXV	884511	898357	SSDCluster	YOR304W,YOR304C-A,YOR305W,YOR306C,YOR307C,YOR308C,YOR309C,YOR310C	5	0	3	8
chrXV	899052	899925	Complement	YOR311C	0	0	1	1
chrXV	900246	931078	WGDCluster	YOR312C,YOR313C,YOR314W,YOR314W-A,YOR315W,YOR316C,YOR316C-A,YOR317W,YOR318C,YOR319W,YOR320C,YOR321W,YOR322C,YOR323C,YOR324C,YOR325W,YOR326W,YOR327C	0	7	11	18
chrXV	931799	944354	Complement	YOR328W,YOR329C,YOR329W-A,YOR330C,YOR331C,YOR332W	0	0	6	6
chrXV	944537	956620	SSDCluster	YOR333C,YOR334W,YOR335C,YOR335W-A,YOR336W,YOR337W	3	0	3	6
chrXV	956894	967622	WGDCluster	YOR338W,YOR339C,YOR340C,YOR341W,YOR342C	0	2	3	5
chrXV	968144	971891	Complement	YOR343C,YOR343W-B,YOR343W-A	0	0	3	3
chrXV	977190	988779	SSDCluster	YOR344C,YOR345C,YOR346W,YOR347C,YOR348C	2	1	2	5
chrXV	989785	1018744	Complement	YOR349W,YOR350C,YOR351C,YOR352W,YOR353C,YOR354C,YOR355W,YOR356W,YOR357C,YOR358W,YOR359W,YOR360C,YOR361C,YOR362C	0	0	14	14
chrXV	1020219	1034180	WGDCluster	YOR363C,YOR364W,YOR365C,YOR366W,YOR367W,YOR368W,YOR369C,YOR370C,YOR371C	1	5	3	9
chrXV	1034804	1039387	Complement	YOR372C,YOR373W	0	0	2	2
chrXV	1039837	1047801	SSDCluster	YOR374W,YOR375C,YOR376W,YOR376W-A,YOR377W	2	1	2	5
chrXV	1049508	1052928	Complement	YOR378W,YOR379C,YOR380W	0	0	3	3
chrXV	1055542	1057678	WGDCluster	YOR381W	0	1	0	1
chrXV	1058420	1059990	Complement	YOR381W-A,YOR382W	0	0	2	2
chrXV	1060438	1090495	SSDCluster	YOR383C,YOR384W,YOR385W,YOR386W,YOR387C,YOR388C,YOR389W,YOR390W,YOR391C,YOR392W,YOR393W,YOR394W,YOR394C-A,YOR396W,YOR396C-A	10	0	5	15
chrXVI	279	16868	SSDCluster	YPL283C,YPL283W-A,YPL283W-B,YPL282C,YPL281C,YPL280W,YPL279C,YPL278C,YPL277C	8	0	1	9
chrXVI	17947	19079	Complement	YPL276W,YPL275W	0	0	2	2
chrXVI	22937	26064	WGDCluster	YPL274W,YPL273W	0	2	0	2
chrXVI	26610	30267	Complement	YPL272C,YPL271W	0	0	2	2
chrXVI	30481	55153	SSDCluster	YPL270W,YPL269W,YPL268W,YPL267W,YPL266W,YPL265W,YPL264C,YPL263C,YPL262W,YPL261C,YPL260W,YPL259C,YPL258C	5	0	8	13
chrXVI	56747	63860	Complement	YPL257W-A,YPL257W-B,YPL257W	0	0	3	3
chrXVI	64976	79353	WGDCluster	YPL256C,YPL255W,YPL254W,YPL253C,YPL252C,YPL251W,YPL250C,YPL249C-A,YPL250W-A,YPL249C	0	4	6	10
chrXVI	79710	82356	Complement	YPL248C	0	0	1	1
chrXVI	82624	84196	SSDCluster	YPL247C	1	0	0	1
chrXVI	84508	96258	Complement	YPL246C,YPL245W,YPL244C,YPL243W,YPL242C,YPL241C	0	0	6	6
chrXVI	96495	98625	WGDCluster	YPL240C	0	1	0	1
chrXVI	99886	105440	SSDCluster	YPL239W,YPL238C,YPL237W,YPL236C,YPL235W,YPL234C	5	0	1	6
chrXVI	106171	106822	Complement	YPL233W	0	0	1	1
chrXVI	107274	153148	WGDCluster	YPL232W,YPL231W,YPL230W,YPL229W,YPL228W,YPL227C,YPL226W,YPL225W,YPL224C,YPL223C,YPL222W,YPL222C-A,YPL221W,YPL220W,YPL219W,YPL218W,YPL217C,YPL216W,YPL215W,YPL214C,YPL213W,YPL212C	2	11	9	22
chrXVI	153493	157592	Complement	YPL211W,YPL210C,YPL209C	0	0	3	3
chrXVI	157840	159592	SSDCluster	YPL208W	1	0	0	1
chrXVI	159907	167397	Complement	YPL207W,YPL206C,YPL205C,YPL204W,YPL203W	0	0	5	5
chrXVI	168086	194144	WGDCluster	YPL202C,YPL201C,YPL200W,YPL199C,YPL198W,YPL197C,YPL196W,YPL195W,YPL194W,YPL193W,YPL192C,YPL191C,YPL190C,YPL189C-A,YPL189W,YPL188W,YPL187W	1	6	10	17
chrXVI	194510	195647	Complement	YPL186C,YPL185W	0	0	2	2
chrXVI	195948	197787	SSDCluster	YPL184C	1	0	0	1
chrXVI	199093	212783	Complement	YPL183W-A,YPL183C,YPL182C,YPL181W,YPL180W,YPL179W,YPL178W	0	0	7	7
chrXVI	213040	218362	WGDCluster	YPL177C,YPL176C	0	2	0	2
chrXVI	218628	225740	Complement	YPL175W,YPL174C,YPL173W,YPL172C	0	0	4	4
chrXVI	226167	237106	SSDCluster	YPL171C,YPL170W,YPL169C,YPL168W,YPL167C	2	0	3	5
chrXVI	237336	241496	Complement	YPL166W,YPL165C,YPL164C	0	0	3	3
chrXVI	241916	242699	WGDCluster	YPL163C	0	1	0	1
chrXVI	243204	250261	Complement	YPL162C,YPL161C,YPL160W	0	0	3	3
chrXVI	250905	275866	SSDCluster	YPL159C,YPL158C,YPL157W,YPL156C,YPL155C,YPL154C,YPL153C,YPL152W-A,YPL152W,YPL151C,YPL150W,YPL149W,YPL148C,YPL147W	4	0	10	14
chrXVI	276160	277528	Complement	YPL146C	0	0	1	1
chrXVI	278393	306136	WGDCluster	YPL145C,YPL144W,YPL143W,YPL142C,YPL141C,YPL140C,YPL139C,YPL138C,YPL137C,YPL136W,YPL135W,YPL135C-A,YPL134C,YPL133C,YPL132W,YPL131W,YPL130W,YPL129W	0	12	6	18
chrXVI	306531	324286	Complement	YPL128C,YPL127C,YPL126W,YPL125W,YPL124W,YPL123C,YPL122C,YPL121C,YPL120W,YPL119C-A	0	0	10	10
chrXVI	324409	326263	WGDCluster	YPL119C	0	1	0	1
chrXVI	326626	335485	Complement	YPL118W,YPL117C,YPL116W,YPL115C	0	0	4	4
chrXVI	335946	347388	SSDCluster	YPL114W,YPL113C,YPL112C,YPL111W,YPL110C,YPL109C	4	1	1	6
chrXVI	348442	349862	Complement	YPL108W,YPL107W	0	0	2	2
chrXVI	350190	355409	WGDCluster	YPL106C,YPL105C	0	2	0	2
chrXVI	355696	361576	Complement	YPL104W,YPL103C,YPL102C,YPL101W	0	0	4	4
chrXVI	361868	363359	SSDCluster	YPL100W	1	0	0	1
chrXVI	363516	368015	Complement	YPL099C,YPL098C,YPL097W,YPL096C-A,YPL096W	0	0	5	5
chrXVI	368067	384405	WGDCluster	YPL095C,YPL094C,YPL093W,YPL092W,YPL091W,YPL090C,YPL089C,YPL088W,YPL087W	0	3	6	9
chrXVI	384769	393651	Complement	YPL086C,YPL085W	0	0	2	2
chrXVI	394034	396569	SSDCluster	YPL084W	1	0	0	1
chrXVI	396698	404080	Complement	YPL083C,YPL082C	0	0	2	2
chrXVI	404946	410087	WGDCluster	YPL081W,YPL080C,YPL079W,YPL078C,YPL077C	0	2	3	5
chrXVI	410439	415359	Complement	YPL076W,YPL075W	0	0	2	2
chrXVI	415759	418024	SSDCluster	YPL074W	1	0	0	1
chrXVI	418495	434087	Complement	YPL073C,YPL072W,YPL071C,YPL070W,YPL069C,YPL068C,YPL067C,YPL066W,YPL065W,YPL064C,YPL063W,YPL062W,YPL061W	0	0	13	13
chrXVI	434519	435761	SSDCluster	YPL060W	1	0	0	1
chrXVI	439424	450374	Complement	YPL060C-A,YPL059W,YPL058C	0	0	3	3
chrXVI	451905	463836	WGDCluster	YPL057C,YPL056C,YPL055C,YPL054W,YPL053C,YPL052W,YPL051W,YPL050C,YPL049C	0	3	6	9
chrXVI	464397	465645	SSDCluster	YPL048W	1	0	0	1
chrXVI	465958	475738	Complement	YPL047W,YPL046C,YPL045W,YPL044C,YPL043W,YPL042C,YPL041C	0	0	7	7
chrXVI	475989	514176	SSDCluster	YPL040C,YPL039W,YPL038W-A,YPL038W,YPL037C,YPL036W,YPL035C,YPL034W,YPL033C,YPL032C,YPL031C,YPL030W,YPL029W,YPL028W,YPL027W,YPL026C,YPL025C,YPL024W,YPL023C,YPL022W,YPL021W,YPL020C	7	4	11	22
chrXVI	514508	520231	WGDCluster	YPL019C,YPL018W,YPL017C	0	3	0	3
chrXVI	521010	538933	Complement	YPL016W,YPL015C,YPL014W,YPL013C,YPL012W,YPL011C,YPL010W,YPL009C	0	0	8	8
chrXVI	539381	551654	SSDCluster	YPL008W,YPL007C,YPL006W,YPL005W,YPL004C	2	0	3	5
chrXVI	552016	566668	Complement	YPL003W,YPL002C,YPL001W,YPR001W,YPR002W,YPR002C-A,YPR003C,YPR004C,YPR005C	0	0	9	9
chrXVI	567265	568993	SSDCluster	YPR006C	1	0	0	1
chrXVI	569332	571375	Complement	YPR007C	0	0	1	1
chrXVI	573014	577355	WGDCluster	YPR008W,YPR009W	0	2	0	2
chrXVI	577581	582731	Complement	YPR010C,YPR010C-A	0	0	2	2
chrXVI	583058	599548	SSDCluster	YPR011C,YPR012W,YPR013C,YPR014C,YPR015C,YPR016C,YPR016W-A,YPR017C,YPR018W,YPR019W	4	0	6	10
chrXVI	599866	612721	Complement	YPR020W,YPR021C,YPR022C,YPR023C,YPR024W	0	0	5	5
chrXVI	613373	658935	SSDCluster	YPR025C,YPR026W,YPR027C,YPR028W,YPR029C,YPR030W,YPR031W,YPR032W,YPR033C,YPR034W,YPR035W,YPR036W,YPR036W-A,YPR037C,YPR038W,YPR039W,YPR040W,YPR041W,YPR042C,YPR043W,YPR044C,YPR045C,YPR046W,YPR047W	9	3	12	24
chrXVI	659178	665487	Complement	YPR048W,YPR049C,YPR050C,YPR051W	0	0	4	4
chrXVI	665689	674697	WGDCluster	YPR052C,YPR053C,YPR054W,YPR055W,YPR056W,YPR057W,YPR058W,YPR059C	0	4	4	8
chrXVI	674857	684350	Complement	YPR060C,YPR061C,YPR062W,YPR063C,YPR064W,YPR065W,YPR066W,YPR067W,YPR068C	0	0	9	9
chrXVI	684552	691786	SSDCluster	YPR069C,YPR070W,YPR071W,YPR072W	3	0	1	4
chrXVI	691929	692415	Complement	YPR073C	0	0	1	1
chrXVI	692792	703968	WGDCluster	YPR074C,YPR074W-A,YPR075C,YPR076W,YPR077C,YPR078C,YPR079W,YPR080W,YPR081C	0	3	6	9
chrXVI	704222	711136	Complement	YPR082C,YPR083W,YPR084W,YPR085C,YPR086W	0	0	5	5
chrXVI	711351	713026	SSDCluster	YPR087W,YPR088C	2	0	0	2
chrXVI	713272	731017	Complement	YPR089W,YPR091C,YPR092W,YPR093C,YPR094W,YPR095C,YPR096C,YPR097W,YPR098C,YPR099C,YPR100W,YPR101W	0	0	12	12
chrXVI	731221	731746	WGDCluster	YPR102C	0	1	0	1
chrXVI	732346	745571	Complement	YPR103W,YPR104C,YPR105C,YPR106W,YPR107C,YPR108W,YPR108W-A,YPR109W	0	0	8	8
chrXVI	745825	767492	SSDCluster	YPR110C,YPR111W,YPR112C,YPR113W,YPR114W,YPR115W,YPR116W,YPR117W	4	2	2	8
chrXVI	767749	768985	Complement	YPR118W	0	0	1	1
chrXVI	771650	775180	WGDCluster	YPR119W,YPR120C	0	2	0	2
chrXVI	778578	780297	Complement	YPR121W	0	0	1	1
chrXVI	782040	794494	SSDCluster	YPR122W,YPR123C,YPR124W,YPR125W,YPR126C,YPR127W,YPR128C,YPR129W,YPR130C,YPR131C	4	0	6	10
chrXVI	794960	810265	Complement	YPR132W,YPR133C,YPR133W-A,YPR134W,YPR135W,YPR136C,YPR137W,YPR137C-B,YPR137C-A	0	0	9	9
chrXVI	810979	812449	WGDCluster	YPR138C	0	1	0	1
chrXVI	813151	821419	Complement	YPR139C,YPR140W,YPR141C,YPR142C,YPR143W,YPR144C	0	0	6	6
chrXVI	822615	844016	WGDCluster	YPR145W,YPR145C-A,YPR146C,YPR147C,YPR148C,YPR149W,YPR150W,YPR151C,YPR152C,YPR153W,YPR154W,YPR155C,YPR156C,YPR157W,YPR158W	3	6	6	15
chrXVI	844704	856253	Complement	YPR158W-B,YPR158W-A,YPR158C-D,YPR158C-C	0	0	4	4
chrXVI	857578	859741	WGDCluster	YPR159W	0	1	0	1
chrXVI	860309	862857	Complement	YPR159C-A,YPR160W,YPR160W-A,YPR160C-A	0	0	4	4
chrXVI	864444	875993	SSDCluster	YPR161C,YPR162C,YPR163C,YPR164W,YPR165W	2	1	2	5
chrXVI	876277	885554	Complement	YPR166C,YPR167C,YPR168W,YPR169W,YPR170C,YPR169W-A,YPR170W-B,YPR170W-A,YPR171W	0	0	9	9
chrXVI	885791	888704	WGDCluster	YPR172W,YPR173C,YPR174C	0	2	1	3
chrXVI	888969	891039	Complement	YPR175W	0	0	1	1
chrXVI	891096	901554	SSDCluster	YPR176C,YPR177C,YPR178W,YPR179C,YPR180W,YPR181C,YPR182W,YPR183W	6	0	2	8
chrXVI	902039	920483	Complement	YPR184W,YPR185W,YPR186C,YPR187W,YPR188C,YPR189W,YPR190C,YPR191W	0	0	8	8
chrXVI	921855	939667	SSDCluster	YPR192W,YPR193C,YPR194C,YPR195C,YPR196W,YPR197C,YPR198W,YPR199C,YPR200C	5	0	4	9
chrXVI	939917	947334	Complement	YPR201W,YPR202W,YPR203W,YPR204W,YPR204C-A	0	0	5	5
